고토의 다른 뜻은 다음과 같다.

지명
고토구(江東区, こうとうく)
고토시(五島市, ごとうし)
고토 열도(五島列島, ごとうれっとう): 나가사키현 서쪽의 동해와 동중국해의 경계에 있는 섬들
고토 역 (야마구치현)(厚東駅, ことうえき): 일본 야마구치현 우베 시에 있는 서일본 여객철도 산요 본선의 역
고토 역 (돗토리현)(後藤駅, ごとうえき): 일본 돗토리현 요나고 시에 위치한 서일본 여객철도 사카이 선의 철도역
고토역(古土驛): 조선민주주의인민공화국 함경남도 장진군에 위치한 장진선의 철도역

화학
고토(苦土)는 산화 마그네슘이다.

음악
고토(箏)는 일본의 현악기이다.

인명
고토 마키: 일본의 아이돌 가수, 배우
고토 신페이: 이와테현 출신의 일본 제국의 의사자 관료, 정치가며 정2위 훈1등 백작
고토 모에: 일본의 가수로, AKB48 팀A의 멤버
고토 라라: 일본 여성 아이돌 그룹 SKE48 팀E 와 러브 크레센도 와 무시카고 의 멤버
고토 유우코: 일본의 성우
고토 후미오 (메이지 시대): 다이쇼·쇼와기의 관료이자 정치가로, 오이타현 출신
고토 사오리
고토 쇼지로: 막말의 도사 번사
고토 준지 (애니메이션 제작자): 일본의 프리 애니메이터 겸 게임 원화가
고토 모토쓰구: 아즈치모모야마 시대부터 에도 시대 초기까지의 무장
고토 미쓰타카: 일본의 프로 야구 선수이며, 현재 퍼시픽 리그인 도호쿠 라쿠텐 골든이글스의 소속 선수(내야수)
고토 스미하루: 센고쿠 시대부터 아즈치모모야마 시대의 다이묘
고토 고지: 일본의 작곡가이자, 기타 연주자
고토 준지
고토 마이
고토 분지로: 일본의 지구과학자
고토 겐지: 일본의 프리랜서 언론인 저널리스트 기자
고토 슌타: 일본 프로 야구의 오릭스 버펄로스에 소속되어 있는 야구선수이며 포지션은 외야수
고토 후미오: 일본의 정치학자
고토 아리토모: 일본 제국의 해군 군인
고토 게이타
고토 하루마사: 센고쿠 시대에서 에도 시대에 걸쳐 활약한 무장, 다이묘
고토 유키: 일본의 여성 아이돌 그룹 전 THE 폿시보(2015년 7월까지), 차오 벨라 칭케티(2015년 7월부터)와 팀 마켄키의 멤버이며, 그라비아 아이돌
고토 유스케: 일본의 축구 선수
파울리나 고토: 멕시코의 배우, 가수
고토 고지 (야구인): 전 NPB 요미우리 자이언츠의 내야수이자, 현 NPB 요미우리 자이언츠의 코치
고토 다로: 일본의 축구 선수
음바 고토: 인도네시아의 슈퍼센티네리언
고토 유지: 일본의 축구 선수
고토 준지 (축구 선수): 일본의 축구 선수
고토 료: 일본의 축구 선수
고토 유키오: 일본의 축구 선수
고토 요시카즈: 일본의 축구 선수