니키는 다음을 가리킨다.

지명
니키 항공: 오스트리아의 저비용 항공사
니키 역: 일본 홋카이도 요이치 군 니키 정에 있는 홋카이도 여객철도 하코다테 본선의 철도역

인명
니키 (가수): 인도네시아의 싱어송라이터, 음악 프로듀서
니키 미나즈: 예명인 니키 미나즈(영어: Nicki Minaj)로 활동하고 있는, 트리니다드 토바고에서 태어난 미국의 래퍼이자 싱어송라이터
니키 버트: 잉글랜드의 축구 코치이자 전 축구 선수
니키 번: 아일랜드의 가수로, 웨스트라이프의 일원
니키 라우다: 오스트리아의 전 카레이서
니키 홉킨스: 영국의 피아노, 오르간 연주자
니키 헤일리: 미국의 정치가
니키 벨라: 미국의 여자 프로레슬링 선수이며, 벨라트윈스의 멤버
니키 카리미: 이란의 배우
니키 양: 미국에 거주하는 한국인 애니메이터
니키 리드: 미국의 배우, 모델, 싱어송라이터
니키 캣: 미국의 배우
니키 힐튼: 미국의 모델, 패션 디자이너
니키 콕스: 미국의 배우
니키 잼: 미국의 가수, 작곡가
니키 아무카버드: 나이지리아 태생의 영국 배우
니키 로메로: 네덜란드의 디스크자키이자 음악 프로듀서
니키 클라인: 캐나다의 배우
니키 드로치: 미국의 배우
니키 크로스: 영국의 여자 프로레슬링선수
니키 리
니키 웰런: 오스트레일리아의 배우
니키 데인: 덴마크의 포르노 배우
니키 드 상 팔: 'nanas'조각(거대하고 풍만한 여성 조각)으로 알려진 프랑스 태생 아티스트
니키 야노프스키: 캐나다의 싱어송라이터
니키 벤돌라: 이탈리아의 좌익 정치인이자 성소수자 운동가
니키 리 (미술가): 미국 뉴욕을 기반으로 활동했던 대한민국의 사진 작가이자 영화 작가
니키 식스: 미국의 음악가, 머틀리 크루의 일원
니키 미쇼: 미국의 배우
니키 지링: 미국의 모델 및 배우
니키 라이저: 스위스 출신의 영화음악 작곡가
니키 힐: 필리핀의 가수, 배우, 사회자, 모델
니키 블론스키: 미국의 배우
니키 에이콕스: 미국의 배우
니키 하프나: 일본의 축구 선수
니키 진: 미국의 싱어송라이터
니키 수후: 미국의 배우로, 로스앤젤레스 출신의 중국계 미국인
리틀 니키 (가수): 잉글랜드의 싱어송라이터
니키 보이어: 미국의 배우, 싱어송라이터
니키: 한국의 타투이스트

기타
리틀 니키: 2000년 개봉한 미국의 영화로서 애덤 샌들러가 주연한 코미디 영화