데이브(Dave)는 데이비드(David)의 준말이다.

영화
데이브 (영화)

비디오 게임
위험한 데이브: 존 로메로(John Romero)가 만든 컴퓨터 게임

인명
데이브: 잉글랜드의 래퍼
데이브 바티스타: 미국의 프로레슬링선수, 배우
데이브 윈필드: 미국의 전 메이저 리그 야구 선수로 우익수
데이브 로버츠
데이브 머스테인: 미국의 기타리스트, 가수, 송라이터, 배우, 작가
데이브 레빈: 대한민국에서 활동하는 미국의 엔터테이너
데이브 부시: 미국의 야구 선수이자, 전 한국 프로 야구 SK 와이번스의 투수
데이브 패럴: 대개 "피닉스"로 잘 알려진 미국의 베이시스트
데이브 그롤: 미국의 록 음악가
데이브 로저스: 이탈리아 만토바에서 출생한 가수이자 작곡가, 음악 프로듀서
데이브 엘렙슨: 미국 헤비메탈 밴드 메가데스의 베이시스트
데이브 그루신: 1957년 재즈 피아니스트로 첫 데뷔한 미국의 작곡가
데이브 론트리: 잉글랜드의 음악가
데이브 에번스: 오스트레일리아의 가수
데이브 폴스키: 미국의 시나리오 작가
데이브 스튜어트 (야구 선수): 미국의 프로 야구 총장, 투수 코치, 스포츠 중계인으로 은퇴한 출발 투수
데이브 잉글랜드: 미국의 스턴트 배우
데이브 기번스: 영국 출신의 만화 그림 작가
데이브 위튼버그: 미국의 성우
데이브 프랭코: 미국의 배우
데이브 브루벡: 미국의 재즈 음악가
데이브 매슈스 밴드: 미국의 록 밴드
데이브 셔펠: 미국의 배우이자 희극인
데이브 매카이: 스코틀랜드의 전 축구 선수이자 감독
데이브 핀레이: 흔히 줄여서 핀레이(Finlay) 라고 불리는 과거 WWE에서 활동을 했었던 프로레슬링선수
데이브 웰런: 영국의 스포츠 재벌
데이브 나바로: 미국의 기타리스트
데이브 롬바르도: 쿠바 출신이며 미국의 스래시 메탈 밴드 슬레이어의 공동 창립자이자 드러머
데이브 매슈스: 미국의 가수
데이브 그린: 미국의 영화 감독, 뮤직비디오 감독
데이브 르게노: 잉글랜드의 배우 및 격투가
데이브 메이슨: 영국의 기타 연주자 겸 싱어송라이터
데이브 바솔로뮤: 20세기 후반 동안 뉴올리언스의 음악에서 두드러진 미국의 음악가, 밴드리더, 작곡가, 감독, 음반 제작자
데이브 브레일스퍼드
데이브 폴리: 캐나다의 배우 및 희극인
데이브 데이비스: 영국의 싱어송라이터 겸 기타리스트
데이브 쿨리어: 미국의 희극인이자 배우
데이브 비클러: 미국의 록 가수 겸 작사가이며 작곡가
데이브 애나블: 미국의 배우
데이브 체케츠: 미국의 기업인이자 스포츠 재벌
데이브 헤이우드: 미국의 컨트리 음악가
데이브 크루센: 미국의 록 드러머
데이브 펜사도: 2008년 그래미상을 수상한 믹싱 엔지니어이자 프로듀서
데이브 킷슨
데이브 웨클: 미국의 재즈 퓨전 드러머
데이브 사보: 미국의 기타 연주자
데이브 가안: 영국의 싱어송라이터
데이브 올브리튼: 미국의 육상 선수로 두발을 벌린 기술을 사용한 첫 높이뛰기 선수들 중의 하나
데이브 호커데이: 잉글랜드의 전 축구 선수
데이브 코긴: 2000년부터 2002년까지 필라델피아 필리스에서 뛴 투수