로의 다른 뜻은 다음과 같다.

문자·언어
Ρ는 그리스 문자이다.
ろ(로)는 일본어 가나 중 하나이다.

지리, 지명
로 (이탈리아)
로 (대한민국의 행정 구역)(路)는 길을 뜻한다. 대한민국에서는 행정구역 단위로도 쓰인다. (읍면동급)
로 (송나라): 송나라부터 금나라까지 중세 중국의 지방 행정 구획의 최고 단위

인물
노 한국, 중국 등의 성씨
루이즈 로(Louise Roe): 잉글랜드의 사회자, 패션 언론인
존 로(John Law, 1671-1729)는 스코틀랜드의 재정가이다.
앤드루 보너 로(Andrew Bonar Law, 1858-1923)는 캐나다 출신의 영국 정치인이다.
유진 로(Eugene Gilbert "Doc" Roe Sr., 1921-1999)는 미국의 군인이다.
토머스 로(Thomas Roe, 1581?-1644)는 영국의 외교관이다.
주드 로: 잉글랜드의 배우
데니스 로: 스코틀랜드의 전 축구 선수
조바니 로 셀소: 아르헨티나의 축구 선수
에드워드 로: 해적의 황금시대 후기인 18세기 초기에 활동한 악명높은 영국계 해적
롭 로: 미국의 배우
데릭 로: 전 미국의 메이저 리그 우완 투수 야구 선수
더그 로: 영국의 육상 선수
크리스털 로: 캐나다의 배우
니컬러스 로: 스코틀랜드의 배우
토베 로: 스웨덴의 싱어송라이터
찰리 로: 잉글랜드의 배우
네이선 로: 홍콩의 정치인
마크 로: 미국 출신의 야구 선수
크리스 로: 잉글랜드의 음악가
데이지 로: 잉글랜드의 모델
채드 로: 미국의 배우
이스마엘 로: 세네갈의 음악가이자 배우
프레더릭 로: 미국의 정치인
토머스 로 프라이스: 미국의 투자가
올리버 로: 아프리카계 미국인 공산주의자로서, 노동운동 조직가, 사회운동가
브래드 로: 미국의 배우
잭 로: 19세기 메이저 리그 야구 선수
쇼리 로: 미국의 힙합 가수
토미 로: 미국의 가수
허드슨 로: 아일랜드계 영국의 군사지휘관
카트리나 로: 미국의 배우
앨릭스 로: 잉글랜드의 배우
로 보즈워스: 미국의 방송 유명인, 작가, 사업가
소피 로: 오스트레일리아의 배우, 싱어송라이터
마이크 로: 미국의 내레이터이자 방송인
안드로메다자리 로: 안드로메다자리의 항성
앨리스 로: 잉글랜드의 코메디언, 배우, 작가
자코모 로: 이탈리아 예수회 소속 중국 선교사
루이지 로 카시오: 이탈리아의 배우
프레드릭 로 옴스테드: 현대 도시공원의 시작점에서 주요한 역할을 해낸 도시공원설계자
토드 로: 미국의 배우
에를렌 로: 노르웨이의 소설가이자 영화 각본가
로 카우피: 스웨덴의 배우, 가수
마이클 앤드류 로: 홍콩 현대 아티스트, 화가, 홍콩 영화 제작자
로지 로: 영국의 싱어송라이터, 프로듀서
캐서린 로 해그퀴스트: 캐나다 밴쿠버 출신의 배우이자 방송 프로듀서

가공의 인물
트라팔가 로: 일본의 만화 및 애니메이션 원피스의 등장인물

음악, 영화
로(Low)는 플로 라이다의 노래다.
《로우》(Raw)는 2016년 프랑스, 벨기에의 공포 영화이다.