로스는 다음과 같은 뜻을 갖는다.

로스는 돼지고기, 소고기, 오리고기, 닭고기 등을 구운 고기구이이다.

지명
남극의 지명로스 섬
로스 해
로스 속령: 뉴질랜드가 영유권을 주장하고 있는 남극 대륙의 지방
로스 빙붕: 남극의 빙붕미국의 지명로스 군
로스 요새: 미국 캘리포니아주 소노마 군에 세워진 러시아 양식의 요새프랑스의 지명로스 (노르주): 프랑스 노르파드칼레 노르주에 위치한 도시

천체
로스 128: 처녀자리에 있는 적색 왜성으로 지구에서 10.92광년 떨어져 있다
로스 128 b: 처녀자리에 위치한 로스 128를 돌고 있는 외계 행성
로스 154
로스 248
로스 614

실존 인물
로널드 로스(Ronald Ross, 1857~1932)는 영국의 병리학자이다.
캐서린 로스: 미국의 배우
로스 바클리: 잉글랜드의 축구 선수
로스 울프: 미국의 야구 선수이자, 메이저 리그 텍사스 레인저스의 투수
짐 로스: 미국의 남자 전 프로레슬링선수, 스포츠해설자
다이애나 로스: 미국의 가수이자 배우, 음악 프로듀서
릭 로스: 미국의 랩가수
팀 로스: 영국의 배우이자 감독
트레이시 엘리스 로스: 미국의 배우, 모델, 코메디언, 사회자
제3대 로스 백작 윌리엄 파슨스: 영국-아일랜드계 천문학자
에릭 로스: 미국의 각본가
애티커스 로스: 영국 잉글랜드의 작곡가, 프로듀서
라자로스 흐리스토둘로풀로스: 그리스의 축구 선수
게리 로스: 미국의 영화 감독
알렉산드로스 쿠문두로스: 그리스의 정치가
제임스 클라크 로스: 영국의 해군 군인이자 탐험가, 지리학자
일라이 로스: 미국의 영화 감독 및 배우
필립 로스: 미국의 소설가
울리 존 로스: 독일의 기타리스트이며 스콜피언스의 리드 기타리스트
데이빗 리 로스: 미국의 록 가수, 작곡가, 배우, 작가, 그리고 전직 라디오 방송인
베로니카 로스: 미국의 소설가
로스 배그더세리언: 미국의 배우, 음악가, 성우, 피아노 연주자, 영화 프로듀서, 음악 프로듀서
로스 페로: 미국의 기업인, 정치인
로버트 로스: 나폴레옹 전쟁과 1812년 에 참가한 앵글로 아일랜드계 영국군 장교
케이티 로스: 미국의 배우
조너선 로스: 잉글랜드의 사회자, 영화 평론가
로스 캐츠: 미국의 영화 프로듀서, 영화 감독
에반겔로스 베니젤로스: 그리스 사회당의 당수
밥 로스: 미국의 화가이며 예비역 미국 공군 상사
존 로스
로스 프리먼: 현장 프로그래머블 게이트 어레이(FPGA)의 발명가이고 자이링스의 공동 창업자
로스 토머스
로스 턴불: 잉글랜드의 축구 선수
알렉산드로스 니콜로풀로스: 그리스의 역도 선수
로스 배그더세리언 주니어: 미국의 성우, 음악 프로듀서
맷 로스: 미국의 배우이자 감독, 각본가
루크 로스: 브라질의 만화가
앤드리아 로스: 캐나다의 배우
존 로스 (음악가): 미국의 록 기타리스트 겸 작사가이며 작곡가
앨릭스 로스: 미국의 만화가
니콜 로스: 미국의 플뢰레 펜싱 선수
로스 린치: 미국의 가수이자 배우
로스 앤드루: 미국의 만화가, 만화 편집자
제시카 로스: 미국의 배우
아나 로스: 독일의 배우, 가수
애셔 로스: 미국의 래퍼
빅토리아 데 로스 앙헬레스: 스페인의 성악가
숀 로스: 미국의 모델, 배우, 댄서
로스 마퀀드: 미국의 배우
로스 파트리지: 미국의 배우
에번 로스: 미국의 배우 및 가수
라이언 로스: 미국 라스베이거스에서 결성된 록 밴드 패닉 앳 더 디스코의 전 기타리스트 겸 작사가
에드문도 로스: 트리니다드 토바고에서 태어난 음악가
존 로스 (탐험가): 영국의 해군 군인이자 탐험가
로스 배글리: 미국의 배우
안드레아 로스 (1993년): 스페인의 배우
매리언 로스: 미국의 배우
로스 매키니스: 오스트레일리아의 기업인
로비 로스: 메이저 리그 보스턴 레드삭스의 선수
로스 켐프: 잉글랜드의 배우
로스 매콜: 스코틀랜드의 배우
디오도로스 시켈로스: 그리스의 역사가
앨빈 로스: 미국의 경제학자
클라우스 로스: 영국의 수학자
엘리자베스 퀴블러 로스: 미국의 정신과 의사

가공의 인물
하이먼 로스: 프랜시스 포드 코폴라 감독이 제작한 대부2에 등장하는 인물 중 하나
선더볼트 로스: 마블 코믹스가 발행하는 만화책의 빌런이자 안티히어로
베티 로스: 마블 코믹스가 발행하는 만화책의 등장인물
에버렛 K. 로스: 마블 스튜디오에서는 CIA 부국장이자 베를린에 위치한 합동 대테러 센터의 일원

비디오 게임
라인오브사이트 : 블랙스팟엔터테인먼트가 개발하고 Steam이 제공하는 게임 Line of Sight의 국문 약어이다.

같이 보기
ROS
LOS