루스(Ruth, Luz 등)는 다음을 의미한다.

인명
루스(Ruth)는 여성 이름이며 룻기의 룻이라는 사람에게서 비롯한 말이다.
루스(留守)는 일본의 사람 이름이다.
베이브 루스: 메이저 리그 베이스볼의 전설적인 홈런왕
루스 베네딕트: 미국 뉴욕 출생의 인류학자
루스 마사카게(留守政景): 일본 센고쿠 시대, 에도 시대의 인물
루스 무네토시(留守宗利): 일본 에도 시대 센다이 번의 가신
조제 파그네르 시우바 다 루스(José Fágner Silva da Luz): 브라질의 축구 선수
카를루스 아드리아누 지 소우사 크루스: 브라질의 축구 선수
루스 고든: 미국의 배우
크리스티안 루스 랑에: 노르웨이의 평화주의자
카롤루스 마르텔루스: 카롤링거 왕조 출신 프랑크 왕국의 군주
루스 윌슨: 잉글랜드의 배우
루스 네가: 아일랜드의 배우
루스 프라워 자브발라: 독일 태생 영국의 작가, 영화 각본가
루스 회르츠: 네덜란드의 여자 축구 선수
마르코 루스: 독일의 축구 선수로 포지션은 중앙 수비수
루스 크리스토퍼: 미국의 전 프로 야구 선수
루스 베이더 긴즈버그: 미국 연방 대법원 대법관
카롤루스 파르불루스: 카롤링거 왕조 출신 아키텐의 군주
루스 세인트데니스: 미국의 무용가
루스 구니야스: 미즈사와 다테 가문의 13대 당주
루스 그레이엄: 미국의 남침례회 목사인 빌리 그레이엄의 부인
네이트 루스: 미국의 싱어송라이터
루스 벨라 구티에레스 포르투뇨: 대학 교수 출신의 미국·푸에르토리코 여성 외교관 겸 정치가
헨리 루스: 미국의 잡지 발행인이자 출판업자
루스 렌델: 잉글랜드의 작가
루스 워릭: 미국의 가수이자, 배우, 사회 운동가
루스 브래들리: 아일랜드의 배우
루스 퍼스트: 남아프리카 공화국의 정치인
사샤 루스: 러시아의 모델, 배우
페파 루스: 스페인의 배우, 코메디언, 가수
루스 B: 캐나다의 싱어송라이터

같이 보기
발레 루스 (Ballets Russes)
루스 체인지 (Loose Change)