영어에서 리나(Lina)는 안젤리나 또는 카롤리나의 축약형이다.
리나는 아랍에서 "부드러운"을 뜻하는 여성의 이름으로도 사용된다. 아랍에서 또한 조그마한 젊은 손바닥을 일컫기도 한다.
리나는 또한 다음을 가리키는 말이다.

컴퓨터 과학
리나 (소프트웨어)

인명
리나 메디나: 의학 역사상 최연소에 아이를 출산한 여성
사토 리나: 후쿠오카현 기타큐슈 시 출신의 여성 성우
리나 (테니스 선수): WTA 투어 최고 랭킹 2위에 도달했던 은퇴한 중국의 프로 테니스 선수
리나 (펜싱 선수): 중화인민공화국의 펜싱 에페 선수
우치야마 리나: 일본 카나가와 현에서 태어난 일본의 배우
마츠노 리나 (1998 ~ 2017)
콘도 리나: 일본 여성 아이돌 그룹 전 NMB48 팀M의 멤버
루카와 리나: 일본의 성인 비디오 여배우, 그라비아 아이돌
이코마 리나:  일본의 아이돌이며, 여성 아이돌 그룹 전 노기자카46의 멤버
리나 사스트리: 이탈리아의 배우, 가수
리나 (2001년): 대한민국의 여자 가수
카와에이 리나: 일본의 배우
리나 더넘: 미국의 배우
치카노 리나: 여성 아이돌 그룹 전 JKT48 팀KIII 최연장자
아이우치 리나: 오사카부 히가시오사카 시에서 태어난 일본의 가수
히다카 리나: 일본의 아역배우 출신 여자 배우 겸 성우
이즈타 리나: 여성 아이돌 그룹 BNK48 팀BIII의 멤버
나카니시 리나: 여성 아이돌 그룹「AKB48」의 전 팀A의 멤버
폴리나 가가리나: 러시아의 가수, 배우, 모델
지넨 리나: 오키나와현 출신의 일본의 가수이자 싱어송라이터
마츠모토 리나: 일본 여성 아이돌 그룹 전 SKE48의 멤버
리나 라트케: 독일의 육상 선수
오타 리나: 일본의 모델 겸 배우
후지사와 리나: 일본기원 도쿄본원 소속의 여류 바둑기사
가쓰다 리나
아이자와 리나: 일본의 배우
리나 카추시테: 소비에트 연방을 대표한 리투아니아의 수영 선수
리나 혼: 미국의 가수
키타가와 리나: 일본의 여자 성우
아키야마 리나: 일본 도쿄 출신의 배우이자 그라비아 아이돌, 탤런트
다케다 리나: 일본의 배우이자 가수
리나 베르트뮐러: 이탈리아의 각본가, 영화 감독
카타히라 리나: 일본의 싱어송라이터
리나 체랴조바
리나 소퍼: 미국의 배우
엘리나 스비톨리나: 우크라이나의 프로 테니스 선수
리나 박 (가수): 대한민국의 트로트 가수
리나 라픈: 덴마크의 가수
후지이 리나: 일본의 모델
가메이 리나: 일본의 배우
카리나 아브둘리나: 카자흐스탄의 가수
리나 하이드리히: 나치 독일의 게슈타포 및 SS 보안방첩부의 수장 라인하르트 하이드리히의 부인
사와야마 리나: 일본의 모델, 스케이트 선수, 배우
리나 리펠: 미국의 배우, 가수, 작곡가, 모델
리나 레안데르손: 스웨덴의 배우
리사 리나: 미국의 텔레비전 진행자이자 배우
사쿠라이 리나: 일본의 모델, 가수, 배우
오하시 리나: 일본의 모델
리나 사와야마: 일본 출생 싱어송라이터, 모델
이시하라 리나
리나 폴리토: 이탈리아의 배우
리나 이바노바: 영화배우이자 더빙
리나 오를로바: 에스토니아의 배우
리나 브루넬레: 에스토니아의 배우
고이케 리나: 일본의 배우이자 아이돌

가공의 인물
토우인 리나: 피치피치핏치의 등장인물
리나 인버스(リナ゠インバース/ Lina Inverse)는 애니메이션 슬레이어즈 시리즈에서 나오는 가공의 주인공