릭의 다른 뜻은 다음과 같다.

인명
릭 플레어: 미국의 전 프로레슬링선수
릭 판 덴 휘르크: 네덜란드의 야구 선수
릭 스타이너: 미국의 프로레슬링선수
릭 거톰슨: 미국의 야구선수
릭 루빈: 미국의 음악 프로듀서, 레코드 회사 경영자
릭 바워
릭 포셀로
릭 로스: 미국의 랩가수
릭 베리: 전 미국의 농구 선수
릭 내시
릭 케리: 미국의 수영 선수
릭 빅터: 캐나다의 남자 프로레슬링선수
릭 웨이크먼: 잉글랜드의 음악가
릭 로소비치: 미국의 배우
릭 머래니스: 캐나다의 배우
릭 애스틀리
릭 페리: 미국의 정치인
릭 앨런: 잉글랜드의 드러머
릭 D. 와서먼: 미국의 성우
릭 라이어던: 미국의 소설가
릭 새비지: 잉글랜드의 베이시스트
릭 얀시: 미국의 소설가
릭 윤: 미국의 남자 영화배우
릭 오케이섹: 미국의 싱어송라이터, 음악가, 음악 프로듀서, 화가
릭 울스텐험 주니어: 미국 록 밴드 라이프하우스의 드러머
릭 리멘더: 《언캐니 어벤저스》, 《언캐니 엑스포스》 등의 작품으로 알려진 미국의 만화가
릭 샌토럼: 미국의 정치인
릭 고메즈: 미국의 배우
릭 슈로더: 미국의 배우 및 영화 감독
슬릭 릭: 영국 태생의 미국의 힙합 가수
릭 메이올: 잉글랜드의 배우 및 희극인
릭 곤살레스: 미국의 배우
릭 판 데르 펜: 네덜란드의 남자 양궁 선수
릭 코즈닛: 오스트레일리아의 배우
릭 리어나디: 미국의 만화가
릭 게이츠: 인터넷 헌트(Internet Hunt)를 조직하고 인터피디아 개념을 세운 인터넷의 선구자
릭 스프링필드: 오스트레일리아의 싱어송라이터 겸 뮤지컬 배우
릭 제임스: 미국의 가수
릭 파무이와
릭 파핏: 영국의 가수 겸 작곡가, 기타 연주자
릭 제네스트: 캐나다의 공연가, 배우, 패션모델
릭 호프먼: 미국의 배우
릭 스콧
릭 재크먼: 캐나다 출신의 프로 아이스하키선수
릭 로먼 워: 미국의 스턴트 배우 출신 영화 감독
릭 치크: 미국의 킥복싱, 종합격투기 선수
릭 워렌: 미국의 복음주의 기독교 목사
릭 폭스: 캐나다의 배우, 전직 농구 선수
릭 맬럼브리: 미국의 모델이자 배우
릭 레이츠: 미국의 배우, 텔레비전 배우, 영화배우, 각본가, 영화 프로듀서
릭 스미츠: 네덜란드의 은퇴한 농구 선수
릭 머서: 캐나다의 희극 배우이자 배우, 정치 비평가, 블로거
릭 핸슨: 미국의 신경심리학자이며 명상 지도자
릭 더코먼: 캐나다의 배우, 각본가, 영화배우, 텔레비전 배우
릭 보그너
릭 허스트: 미국의 배우, 텔레비전 배우
제니퍼 릭: 캐나다의 배우
릭 피터스: 미국의 배우, 텔레비전 배우, 영화배우
릭 로버트: 캐나다의 배우, 텔레비전 배우
릭 오버튼: 미국의 배우, 각본가, 텔레비전 배우, 영화배우
릭 샤피로: 미국의 희극 배우, 텔레비전 배우
릭 반 너터: 미국의 배우, 각본가, 영화배우
릭 아빌스: 미국의 배우, 희극 배우, 영화배우
릭 로먼: 미국의 배우, 텔레비전 배우
릭 밸린: 미국의 배우, 텔레비전 배우
릭 렌즈: 미국의 배우, 연극 배우, 텔레비전 배우
릭 제이슨: 미국의 배우, 연극 배우, 텔레비전 배우, 성우, 영화배우

가공의 인물
릭 데커드: 영화 블레이드 러너 시리즈의 등장인물이며 주인공
릭 그라임스: 미국의 만화 《워킹 데드》의 등장인물이자 그 만화를 원작으로 한 동명의 드라마의 등장인물
릭 존스: 마블 코믹스의 등장인물
릭 플래그
릭 헤링: 녹색전차 해모수의 주인공

같이 보기
리크