린다의 다른 뜻은 다음과 같다.

린다 B. 벅: 후각 기관에 관한 연구로 잘 알려진 미국의 생물학자
린다 음부시: 남아프리카 공화국의 배우, 건축가
린다 헌트: 미국의 배우
린다 피오렌티노: 미국의 배우
린다 블레어: 미국의 배우
린다 매카트니: 미국 뉴욕 시의 유대인 가정에서 태어난 사진가로, 비틀즈의 폴 매카트니의 아내
린다 마틴: 아일랜드의 가수
린다 해밀턴: 미국의 배우
린다 에번스: 미국의 배우
린다 래빈: 미국의 배우
린다 크리스털: 아르헨티나, 미국의 배우
린다 맥마흔: 미국의 최대 프로레슬링회사인 WWE의 전 CEO이자 미국의 정치인
린다 매켄지: 오스트레일리아의 수영 선수
린다 울버턴: 미국의 여성 작가
린다 론스태트: 미국의 대중음악 및 컨트리 음악 가수
린다 카델리니: 미국의 배우
린다 린다 린다: 2005년 7월 23일 일본에서 개봉한 영화
린다 카터: 미국의 배우, 가수
린다 청
린다 커즐라우스키: 미국의 전 배우
린다 에먼드: 미국의 배우
솔로몬 린다
린다 페리: 미국의 록 음악가, 작곡가, 프로듀서
린다 리 캐드웰: 미국의 교사
린다 러브레이스: 미국의 포르노 배우
린다 수 박: 미국의 소설가이자 아동문학가로, 한국계 미국인
린다 엘비라: 덴마크의 배우
린다 산체스: 미국 민주당 소속의 정치인
린다 에반젤리스타: 캐나다의 모델
린다 프랜티아니: 미국의 전직 피겨 스케이팅 선수
린다 앤드루스: 페로 제도의 가수
린다 김
린다 캐롤: 미국의 작가이자 결혼과 가족 문제를 다루는 심리치료사
린다 보이드: 캐나다의 배우
린다 순드블라드: 스웨덴의 싱어송라이터, 모델, 배우
린다 박: 한국계 미국인 배우
린다 카르보네토: 캐나다의 피겨 스케이팅 선수
린다 라킨: 미국의 배우, 성우
린다 벵트싱: 스웨덴의 가수
린다 페: 스위스의 미인 대회 우승자, 모델
린다 마리아 바로스: 프랑스의 시인, 번역가, 문학 평론가
린다 프릿샤르드: 스웨덴의 가수, 댄서
린다 크리스티안: 멕시코의 배우
린다 그레이: 미국의 배우
린다 슈탈: 독일의 창던지기 선수
린다 헤세: 독일의 가수
린다 르메이: 캐나다의 싱어송라이터
린다 피라: 콜롬비아 태생인 스웨덴의 래퍼