마르크(Mark)는 여러 나라의 통화 단위로 쓰였다.

마르크 (통화): 통화 단위 가운데 하나
금 마르크: 1873년부터 1914년까지 통용된 독일 제국의 통화
독일 마르크(Deutsche Mark): 서독(1948년부터 1990년까지)과 독일(1990년부터 2002년까지)의 옛 통화
동독 마르크(Ostmark): 옛 동독의 화폐

지명
마르크 시: 스웨덴 베스트라예탈란드주에 위치한 지방 자치체

인명
마르크(Marc 등)는 다음을 의미한다.

프란츠 마르크(Franz Marc, 1880-1916) - 독일의 화가
마르크 판 보멀: 네덜란드의 전 축구 선수, 현 축구 감독
마르크 빌모츠: 과거 벨기에의 축구 선수이자 현 감독
마르크 오버르마르스: 네덜란드 전 축구 선수
마르크 바르트라: 스페인 출신의 축구 선수
마르크 뤼터: 네덜란드의 정치인
마르크 율리아노: 이탈리아의 전 축구 선수
마르크 가뇽: 캐나다의 쇼트트랙 선수
마르크 가솔: 스페인의 농구 선수이자, NBA 토론토 랩터스의 선수
마르크 양코: 오스트리아의 축구 선수로서, 포지션은 스트라이커
마르크 샤갈: 러시아 제국(현 벨라루스)에서 태어난 프랑스의 화가
마르크 플라뉘: 프랑스의 전 축구 선수
헤인리크 마르크: 에스토니아의 정치인
마르크 포르스터: 독일의 영화 감독이자 각본가
마르크 타위터르트: 네덜란드의 스피드 스케이팅 선수
마르크 우트: 독일의 축구 선수
마르크 하위징아: 전 네덜란드의 유도 선수
마르크 알렉상드르: 전 프랑스의 유도 선수
마르크 라발로마나나: 마다가스카르의 전 대통령
마르크 크레인: 소비에트 연방의 수학자
마르크 뒤트루
마르크 무니에사: 스페인의 축구 선수
마르크 레비: 프랑스의 소설가
마르크 우엘레: 캐나다의 가톨릭 성직자
마르크 블로크: 프랑스의 사학자
마르크 슬라빈: 이스라엘의 전 레슬링 선수
마르크 클로테트: 스페인의 배우
길롐 마르크: 스페인 팔마데마요르카 출신의 만화가, 일러스트레이터
요한 1세 폰 마르크: 클레베의 공작이자 마르크의 백작
마르크 오버르마르스 (컴퓨터 과학자): 네덜란드의 컴퓨터 과학자
마르크 아로노비치 나이마르크
마르크 라부안: 프랑스의 가수이자 배우
마르크 후츠코: 슬로바키아의 언어학자
장 마르크 보스만: 벨기에의 축구선수
마르크 비욘: 필리핀의 축구선수
마르크 슈텐데라: 독일의 축구 선수
마르크 마르케스: 스페인의 모터사이클 선수
마르크 리: 스위스 출신의 미디어작가