볼이라는 명칭의 뜻은 다음과 같다.

스포츠
볼(ball) - 공 (운동 기구)
볼 (야구)(ball) - 야구에서 스트라이크 존을 벗어난 공

지명
볼 (Volx) - 프랑스 알프드오트프로방스주의 행정구역

인명
루실 볼: 미국의 배우, 연극 연출가
마크 볼: 미국의 영화 각본가이자 영화 제작자
앨런 볼 (각본가): 미국의 각본가이자 영화 감독 · 프로듀서
앨런 볼 (축구인): 잉글랜드의 축구 감독이자 선수
애슐리 볼: 미국의 가수, 성우
잉리 모에 볼: 노르웨이의 여자 축구 선수
우베 볼: 영화 감독이자 식당 경영자
웨스 볼: 미국의 영화 감독, 시각 효과 감독
윌리엄 볼 (스키 선수): 캐나다의 1936년 동계 올림픽에 참가한 스키 선수
존 볼 (동명이인)
월터 윌리엄 라우스 볼: 영국의 수학자, 변호사
티모 볼: 독일 헤센주 출신의 탁구선수
도미닉 볼: 잉글랜드의 축구 선수
윌리엄 볼: 수비수로 활약한 영국의 축구 선수
수세 볼: 덴마크의 영화 배우, 텔레비전 배우
데버러 로웬버그 볼: 미국의 교육 연구가
존 볼 (사제): 영국 출신의 기독교 성직자, 혁명가, 와트 타일러의 난의 지도자
앨런 볼: 미국의 각본가
존 볼 (청교도)
드와이트 볼: 캐나다의 정치인

그 외
볼 (그릇)(bowl) - 요리용 그릇
뺨의 한복판
볼 - 건담 시리즈의 병기
미트볼, 치즈볼 등의 음식으로 만든 볼