블랙(Black)은 영문으로 검정색을 뜻하며, 다음을 가리키는 말이다.

미디어
영화
블랙 (영화)
블랙 호크 다운 (영화)

드라마
블랙 (드라마)

비디오 게임
블랙 (비디오 게임)

노래
지드래곤 : BLACK

실존 인물
블랙은 다음과 같은 사람들의 성이기도 하다.

조지프 블랙: 스코틀랜드의 화학자, 물리학자
MC 블랙(김성현): 힙합 가수
타일러 블랙: 미국의 남자 프로레슬링선수
캐런 블랙: 미국의 배우
댄 블랙: 미국의 야구 선수
잭 블랙: 미국의 가수, 코미디언, 배우
더스틴 랜스 블랙: 미국의 각본가, 영화 감독, 프로듀서
버드 블랙: 전 메이저 리그 클리블랜드 인디언스의 투수
클로디아 블랙: 오스트레일리아의 배우, 성우
셰인 블랙: 미국의 영화 감독, 각본가, 배우
카라 블랙: 짐바브웨의 테니스 선수
루커스 블랙: 미국의 배우
빌 블랙: 로큰롤의 선구자로 평가되는 미국의 음악가 겸 밴드 리더
알레이스터 블랙: 네덜란드 남자 프로레슬링 선수
밥 블랙: 미국의 아나키스트
앨로 블랙: 미국의 싱어송라이터
그린 바디먼 블랙: 미국의 치과의사
시우 블랙: 베트남의 가수
리베카 블랙: 미국의 팝 가수
토드 블랙: 미국의 영화 프로듀서
블랙 차일드: 미국의 랩가수, 배우
토리 블랙: 미국의 포르노그래피 여우
루이스 블랙: 미국의 코미디언 · 배우 · 극작가
앨릭스 블랙: 미국의 배우
피파 블랙: 오스트레일리아의 배우

가공의 인물
시리우스 블랙: 조앤 롤링의 소설 해리 포터의 등장인물이다.
포켓몬스터 블랙 중 블랙이다.
포켓몬스터 블랙 2 중 블랙 2이다.
제이콥 블랙: 트와일라잇 시리즈의 등장인물이다.
블랙 만타: DC 코믹스의 슈퍼빌런 캐릭터이다.

기타
블랙 사이트: 미국 국외에 있는 비밀 군사 시설

같이 보기
잭 블랙 (동음이의)