아이의 다른 뜻은 다음과 같다.

아이는 나이가 어린 사람을 뜻한다.
아이(I, i)는 로마자의 하나이다.

실존 인물
아이 (파라오) : 이집트 제18왕조의 파라오
아이 (그라비아 아이돌)
AI (가수)
아이 (가수) : 대한민국의 여성 솔로 가수이다.
타카하시 아이: 일본의 여성 아이돌 가수 겸 배우
카고 아이: 일본 나라현 야마토타카다 시 출신의 가수이자 영화 배우, 텔레비전 배우
우에하라 아이: 일본의 여자 성인 비디오 배우
오오츠카 아이: 오사카부 출생의 가수이자 삽화가
노나카 아이: 일본 후쿠오카현 출신의 여성 성우
윌 아이 앰: 윌 아이 앰(Will.i.am)으로 잘 알려진 미국의 래퍼, 프로듀서, 싱어송라이터, 그리고 기업인
시모무라 아이: 일본의 전 성인 비디오 여배우
마에다 아이 (성우): 일본의 성우이자 가수
카야노 아이: 일본의 여성 성우
시미즈 아이: 일본의 성우
하네다 아이: 일본의 배우 및 AV 배우
하시모토 아이 (1996년):  일본의 배우
카토 아이:  일본의 배우
야자와 아이: 일본의 여성 만화가
시바타 아이: 일본의 수영 선수
나가노 아이: 사이타마현 출신의 일본 여성 성우
하루나 아이:  일본의 트랜스젠더 연예인, 패션 모델, 사업가
이지마 아이: 일본의 전직 탤런트이자 성인 비디오 여배우
토쿠나가 아이: 일본의 여자 성우
시노자키 아이: 일본 도쿄 출신의 그라비아 아이돌 겸 가수, 배우
후쿠하라 아이: 일본의 탁구 선수
카와시마 아이: 일본의 여성 싱어송라이터
하시모토 아이: 일본의 패션 모델이자 배우
레프트 아이: 미국의 랩퍼, 싱어송라이터
오카와 아이: 일본의 가수
우치카와 아이: 일본의 성우로 사이타마현 출신이며 시그마 세븐 소속
아이 카나데: 일본의 성인 비디오, 핑크 영화, V 시네마 여배우
하세가와 아이: 일본의 배우
아이 아이리: 일본의 성인 비디오 여배우
오키타 아이: 일본의 여자배우
네기시 아이: 일본 여성 아이돌 그룹인 파스포☆의 리더
모리나가 아이: 일본의 만화가
아이 다쓰야: 일본의 축구 선수
아이 유키: 일본의 성인 비디오 여배우
사물라 아이: 미국의 프로레슬링선수며 사모아계 미국인
사이카와 아이: 일본의 배우, 모델
스타일 오브 아이: 스웨덴의 DJ
유즈키 아이: 일본의 성인 비디오 여배우
마츠모토 아이: 일본의 모델
아이 하이다라: 프랑스의 배우

가공의 인물
스오토메 아이: 《크레용 신짱》에 나오는 등장인물로, 짱구의 친구
하이바라 아이: 아오야마 고쇼의 만화 《명탐정 코난》에 등장하는 인물
카가 아이: 일본의 만화 및 애니메이션 《안녕, 절망선생》의 등장 인물
게임 셔플!의 등장인물 아이

같이 보기
I (동음이의)
AI