아흐마드(احمد, Ahmad)는 이슬람교의 남성 이름이다. 원래는 아라비아어로 무함마드와 근원이 같으므로, 이슬람교의 남성 이름으로서 매우 인기가 있다. 지역에 따라 아흐메드라고 부르는 경우도 있다.

인물
아흐마드아흐마드는 자라이르 왕조의 군주이다.
아흐마드 샤 마수드는 아프가니스탄의 군벌이다.
아흐마드 이븐 아사드는 사만 왕조의 군주이다.
아흐마드 이븐 이스마일(아흐마드 사마니)는 사만 왕조의 군주이다.
아흐마드 파나카티는 원나라의 이슬람계 재상이다.
사바 아흐마드 알자비르 알사바: 쿠웨이트의 5번째 국왕
아흐마드 이브라힘 칼라프: 이라크의 축구 선수
샤리프 셰이크 아흐마드: 소말리아 과도 연방 정부의 7대 대통령
아흐마드 하산 알바크르: 이라크의 정치인
이스마일 이븐 아흐마드
아흐마드 누롤라히: 이란의 축구 선수
아흐마드 알파하드 알아흐메드 알사바: 아시아 올림픽 평의회 회장
사이이드 아흐마드 칸: 인도의 정치가, 교육인, 개혁가, 작가
아흐마드 이븐 이브리힘 알가지: 아달 술탄국의 이맘이자 장군
아흐마드 아부가우시: 요르단의 태권도 선수
아흐마드 샤 두라니: 근대 아프가니스탄의 시발점으로 여기는 두라니 제국의 수립자이자 왕
아흐마드 이븐 파들란: 10세기의 아랍인 탐험가
아부 아흐마드 알아와니: 이라크 및 시리아 일대 테러 조직 이슬람 국가의 조직원
아흐마드 자히르: 아프가니스탄 출신의 가수, 작사가, 작곡가아흐메드아흐메드 칼릴: 아랍에미리트의 축구 선수이며 포지션은 공격수
아흐메드 엘모하마디: 이집트의 축구 선수
아흐메드 모에인: 카타르의 축구 선수
아흐메드 라디: 이라크의 전직 축구 선수이자 현직 정치인
아흐메드 헤가지: 웨스트브로미치 앨비언에서 중앙 수비수로 뛰는 이집트의 축구선수
아흐메드 압디 고다네
아흐메드 파티: 이집트의 축구 선수
아흐메드 샤피크
아흐메드 하산: 이집트의 전 축구 선수로 A매치 최다 출전 선수
아흐메드 나지프: 이집트의 정치인
아흐메드 무힛딘 피리 레이스: 오스만 제국의 해군 제독이자 지도 제작자
아흐메드 아와드 이븐 아우프: 수단의 전 대통령 겸 군인
아흐메드 제말 파샤
압둘라히 유수프 아흐메드: 소말리아의 정치인
아흐메드 야신 가니: 이라크의 축구 선수
이스마일 아흐메드 이스마일: 수단의 육상 선수
게디크 아흐메드 파샤: 오스만 제국의 재상
살림 아흐메드 살림: 탄자니아의 정치인, 외교관
아흐메드 센제르
아흐메드 압달라 모하메드 삼비: 코모로의 이슬람 지도자이자 정치인
아흐메드 알타예브: 이집트의 이슬람학자
아흐메드 도간: 불가리아의 정치인
아흐메드 야세르: 카타르의 축구 선수
이스마일 아흐메드 카다르 하산: 지부티의 축구 선수
아흐메드 엘사카: 이집트의 배우
아흐메드 엘 아오우아드: 프랑스의 축구선수
아흐메드 자키: 이집트의 배우
아흐메드 헬미: 이집트의 배우, 희극인, 텔레비전 진행자