앨프레드(Alfred)는 다음을 가리킨다. 앨프레드 외에도 알프레트, 알프레드, 앨프리드라고도 한다.

지명
포트알프레드(Port Alfred) - 남아프리카공화국의 도시

인물
작센코부르크고타의 알프레트
앨프레드 대왕 - 잉글랜드의 왕
알프레드 카스틀레르: 프랑스의 물리학자
알프레드 G. 길먼: 미국의 생화학자, 약리학자
알프레드 히치콕: 영국과 미국을 오가며 활동한 영화 감독, 영화 제작자
알프레드 드 뮈세: 프랑스의 시인, 소설가, 극작가
알프레드 노스 화이트헤드: 영국의 철학자·수학자
알프레드 핀보가손: 아이슬란드의 축구 선수
알프레드 노벨: 스웨덴의 과학자
알프레드 시슬레: 잉글랜드인으로 프랑스에서 활동한 인상주의 풍경 화가
허요시 알프레드: 헝가리의 수영 선수 출신의 건축가
알프레드 드레퓌스: 드레퓌스 사건으로 알려진 프랑스 육군의 주요 인물
알프레드 네울란드: 에스토니아의 역도 선수
알프레드 코르토: 프랑스의 피아니스트
알프레드 가르시아: 스페인의 가수
알프레드 비네: 프랑스의 심리학자·의사
알프레드 드 비니: 프랑스의 낭만파 시인·소설가·극작가
알프레드 자리: 프랑스의 시인·극작가다
알프레드 르 푸아트뱅: 프랑스의 시인이자 변호사
알프레드 베르거: 오스트리아의 피겨 스케이팅 선수
알프레드 베버: 독일의 사회학자이자 지리학자
알프레드 모이지우: 알바니아의 제4대 대통령
알프레드 알버트: 현재 맨체스터 유나이티드 FC의 전신인 뉴턴 히스 최초의 정규직 근로자로 잘 알려진 사람
알프레드 클라이너: 스위스의 물리학자였으며 취리히 대학교의 실험물리학 교수
알프레드 에젠베이저: 루마니아의 전 축구 선수이자 피겨 스케이팅 선수
알프레드 크루프: 19세기 독일의 기업가
알프레드 코르델린: 핀란드의 기업가, 독지가
알프레드 하르트
알프레드 하우제: 독일의 지휘자 및 바이올린 연주자
알프레드 챈들러: 경영학 교수이자 경영 사상가
알프레드 버나드: 1886~7년 사이에 영국에 있는 모든 위스키를 방문한 저널리스트
알프레드 웹: 인쇄소를 운영하는 가정에서 태어난 아일랜드의 퀘이커
알프레드 토버 (의사): 미국의 의사, 윤리학자
알프레드 부헤러: 독일의 물리학자
알프레드 예르마니시: 슬로베니아의 은퇴한 축구 선수

대학교
앨프레드 대학교 - 미국의 대학교

기술
알프레드 (소프트웨어) - MacOS 용 애플리케이션 런처

같이 보기
알프레도