얼의 다른 뜻은 다음과 같다.

얼은 정신의 줏대를 가리킨다.
얼은 여울의 경북 방언이다.
얼(噦)은 딸꾹질을 가리킨다.

인명
얼 보스틱: 알토 색소폰 주자
얼 윌버 서덜랜드: 미국의 약학자·생리학자
얼 에이버릴: 미국의 전 메이저 리그 베이스볼 선수
제임스 얼 존스: 인상적인 신체의 인격과 자신의 깊고 덜거덕 거리는 목소리를 지닌 아프리카계 미국인 배우
얼 위버: 미국의 전 야구 선수 및 야구 감독
얼 메도스: 미국의 육상 선수
재키 얼 헤일리: 미국의 배우
얼 페이지: 1939년 조지프 라이언즈가 사망한 후 19일간 호주 제11대 총리를 지낸 오스트레일리아의 정치인
얼 워런: 미국의 법조인·정치인
얼 보엔: 미국의 배우 및 성우
얼 하인즈: 미국의 재즈 피아니스트이자 밴드 리더
스티브 얼: 미국의 싱어송라이터이자 배우
제임스 얼 레이: 미국의 백인 우월주의자
얼 클루: 미국의 스무스 재즈, 재즈 퓨전 기타리스트 겸 작곡가
얼 브라우더: 미국의 정치운동가이자 미국 공산당의 당대표
얼 후커: 슬라이드 기타 연주로 유명한 시카고 블루스 기타리스트
로버트 얼 킨: 미국의 컨트리 가수
홀리 얼: 영국의 배우
얼 에비: 미국의 육상 선수
얼 킹: 미국의 블루스 기타리스트이자 싱어송라이터
얼 스웻셔츠: 미국의 래퍼
얼 블루머나워: 미국 민주당 소속의 정치인
얼 데어 비거스: 미국의 소설가이자 극작가

같이 보기
ARL