올리버(Oliver)는 다음을 가리킨다.

영화
《올리버》(Oliver!)는 1968년 영화이다.

실존 인물
사이 올리버(Sy Oliver, 1910년~1988년)는 미국의 가수이다.
올리버 (모델): 한국계 미국인 모델
올리버 칸: 독일의 은퇴한 축구 선수로 현역 시절 포지션은 골키퍼
올리버 스미시스: 영국에서 태어난 미국의 유전학자
올리버 스톤: 미국의 영화감독, 각본가, 제작자
올리버 비어호프: 과거 독일의 축구 선수
올리버 P. 스미스: 미국 해병대의 4성 장군
올리버 크롬웰: 영국의 정치가이며 군인
올리버 뇌빌: 독일의 은퇴한 축구 선수
올리버 하트: 영국에서 태어난 미국의 경제학자
올리버 E. 윌리엄슨: 미국의 경제학자
올리버 헤비사이드: 영국의 수리 물리학자 및 전기 공학자
올리버 R. 에이비슨: 캐나다의 선교사이자 의사
올리버 레크: 은퇴한 독일의 축구 선수
올리버 보자니치: 오스트레일리아의 축구 선수
올리버 노우드: 잉글랜드 태생의 북아일랜드의 축구 선수
올리버 플랫: 캐나다 태생의 미국의 배우
니콜 올리버: 미국의 배우, 성우
올리버 로지: 영국의 물리학자
올리버 맥버니: 스코틀랜드의 축구 선수
올리버 바우만: 독일의 축구 선수로 포지션은 골키퍼
제임스 & 올리버 펠프스: 잉글랜드의 일란성 쌍둥이 배우
올리버 웬들 홈스: 미국의 의학자,시인,수필가,평론가
올리버 색스: 잉글랜드의 신경의학자이며 박물학자
제이미 올리버: 영국의 요리사이자 방송인
올리버 우드
올리버 파커: 잉글랜드의 영화 감독
올리버 잭슨코언: 잉글랜드의 배우
올리버 해저드 페리: 미합중국 해군 사령관
대런 올리버: 미국출신의 전메이저 리그선수
올리버 웬들 홈스 주니어: 미국의 법학자, 연방 대법원 대법관
킹 올리버: 미국의 재즈 코넷 연주자이자 밴드 리더
데이비드 올리버: 미국의 육상 선수
올리버 키르히: 독일의 축구 선수
올리버 그레이: 영국의 남자 프로레슬링선수
올리버 리드: 영국 런던 윔블던 태생의 영화 배우
배럿 올리버: 미국의 배우 및 사진가
올리버 하디: 20세기 초 미국의 코미디언
존 올리버: 잉글랜드의 희극인이자 배우
올리버 로: 아프리카계 미국인 공산주의자
올리버 헬던스: 네덜란드의 DJ, 음악 프로듀서
올리버 허드슨: 미국의 배우
올리버 오도노반: 영국의성공회 사제
올리버 무투쿠지: 짐바브웨의 기타리스트이자 싱어송라이터
올리버 리델: 인더스트리얼 메달 밴드 람슈타인의 베이시스트로 유명한 독일의 음악가
토니 올리버
올리버 그라우: 독일의 예술사학자이자 미디어이론가
올리버 버스웰: 장로교 목사
올리버 피플스
올리버 오클랜드: 오스트레일리아의 배우
크리스티안 올리버: 독일의 배우
필립 올리버: 잉글랜드의 배우이자 모델
올리버쌤: 유튜버

가공의 인물
아리아드네 올리버: 애거사 크리스티가 만들어낸 가공의 인물
올리버 오켄: 한나 몬타나의 등장인물