유아어(幼兒語)는 유아와 대화를 할때 사용되는 언어이다.

나라별 유아어
한국
고까 : 옷이나 신발 따위
고추 : 성기
까꿍 : 어린 아이를 귀여워하며 어를 때 내는 소리이다.
똥꼬 : 항문
멍멍이 : 개, 강아지
야옹이 : 고양이
꿀꿀이 : 돼지
맘마 : 분유, 밥
맴매, 때찌 : 체벌
찌찌 : 젖꼭지
까까 : 과자
쉬 : 배뇨, 소변
응가 : 배변, 대변
지지 : 더럽다
빠빠 : 안녕, 잘가, 헤어질때 인사
삐약이 : 병아리
암 : 물
맘마 : 이유식

일본
찌찌 :가슴

미국
boo boo : 찰과상
poo poo : 대변
pee pee : 소변
ta : thank you (감사합니다)
goo goo ga ga (행복하다)

스페인어권
caca : 대변

불어권
caca : 대변


== 각주 ==