장의 뜻은 다음과 같다.

음식
고추장, 된장, 간장 등 발효된 짠 조미료를 통틀어 장(醬)이라 한다.

해부학
장(腸)은 창자라고도 하며 생물의 소화기 중 한 부분이다. 주로 소화와 흡수, 배설을 담당하고, 작은창자와 큰창자로 나뉜다.
또한 장(臟)은 척추 동물의 체내에 있는 기관, 즉 내장을 의미하기도 한다.

공간
장(場)은 보통 어떠한 일이 펼쳐지는 공간을 말한다. 운동장이 대표적이고 일상적인 용례이다. 물리학에서 장(場)은 물리적 실체로서 힘을 작용시키는 공간으로, 자기장, 중력장, 전기장 따위가 있다.
또한 이 장(場)은 시장처럼 여러 사람이 물건을 사고 파는 곳을 짧게 이르는 말로 쓰이기도 한다.옷장이나 책장처럼 물건을 넣어두는 가구를 통틀어 장(欌)이라 한다.

직위
장(長)은 어떤 조직의 최고권자나 대표자를 말한다.
장(將)은 장기 기물 중 하나이다.
장(張)은 별자리의 하나이다.
장(章, 莊, 壯)은 시호에 쓰이는 글자다.

단위
장(章)은 책이나 글의 내용을 나누는 단위 중 하나이다.
장(丈)은 길이의 단위로 한 자(尺)의 열 배이다.
장(張)은 종이나 유리 따위의 얇고 넓적한 물건을 세는 단위, 활, 쇠뇌, 금슬(琴瑟)을 세는 단위, 얇은 구름의 덩이를 세는 단위, 누에의 씨를 세는 단위다.

인명
장은 한국의 성씨로 장(張)과 장(章), 장(蔣)이 있다.
장 (중국 성씨): 중국의 성씨
장(Jean)은 외국어 이름이다.
장 (시호)
장(長)은 위만조선의 왕자이다.
장은 룩셈부르크 대공이다.
장 마르티농: 프랑스의 지휘자이자 작곡가
장 푸르네: 프랑스의 플룻 연주자이자 지휘자
장 포트리에: 프랑스의 화가, 조각가
장 카를뤼: 프랑스의 그래픽 디자이너
장 바티스트 페랭: 프랑스의 물리학자·화학자
장 조레스: 프랑스의 사회주의자이자 사회당 (프랑스) 활동가
장 뒤자르댕: 프랑스의 배우이자 감독, 프로듀서, 코미디언
장 파울: 독일의 소설가
장 르누아르: 프랑스의 영화 감독, 배우, 프로듀서, 저자
장 2세 (프랑스): 프랑스 발루아 왕가의 제2대 국왕(재위:1350년 - 1364년)
장 가뱅: 프랑스의 배우이자 군인
장 부르갱: 벨기에의 수학자
장 콕토: 프랑스의 시인·소설가·극작가·영화 감독
장 드 라 퐁텐: 프랑스의 시인이자 동화 작가
장 란: 프랑스 혁명 전쟁과 나폴레옹 전쟁 당시의 프랑스의 장군
장 드 브리엔: 프랑스 출신의 십자군
장 시벨리우스: 스웨덴계 핀란드 작곡가
장 1세 드 부르고뉴 공작: 부르고뉴의 공작으로 용담공 필리프의 장남
장 페라: 보크레송 출신의 남성가수 겸 작사·작곡가
장 티롤: 프랑스의 경제학자
장 보세주르: 칠레의 축구 선수
장 피아제: 스위스의 철학자, 자연과학자이며 발달심리학자
장 보드리야르: 대중과 대중문화 그리고 미디어와 소비사회에 대한 이론으로 유명한 철학자이자 사회학자, 미디어 이론가
장 모네: 프랑스의 경제학자이자 외교관
장 (룩셈부르크): 룩셈부르크 대공
장 발: 프랑스의 철학자
장 프랑수아 리오타르: 프랑스의 철학자, 사회학자 및 문학 이론가
장 2세 드 로렌 공작: 1453년부터 사망할 때까지 로렌의 공작
장 1세 드 베리 공작: 프랑스의 왕족
장 외스타슈: 프랑스의 영화 감독
장 마쿤: 카메룬의 축구 선수
장 티가나: 프랑스의 전 축구 선수이자 축구 감독
장 메챙제: 프랑스 낭트 출신의 입체파 화가
장 1세 드 로렌 공작: 1346년부터 사망할때까지의 로렌 공작
장 로슈포르: 프랑스의 배우
올리비에 장: 캐나다의 쇼트트랙 선수
장 크레티앵: 캐나다의 자유당 정치인이며 변호사와 장기적 하원 의원으로 20대 총리 (1993 ~ 2003)
장 프랑수아 질레: 벨기에의 축구 선수
미카엘 장: 제27대 캐나다의 총독
장 누벨: 프랑스의 건축가
장 빅토르 마리 모로: 프랑스 장군
장 2세 드 부르봉 공작: 샤를 1세 드 부르봉과 아녜스 드 부르고뉴 사이에서 태어난 아들
와이클리프 장: 아이티 출신
장 디외도네: 프랑스의 수학자
장 드 라트르 드 타시니: 제1차 세계 대전, 제2차 세계 대전, 그리고 제1차 인도차이나 전쟁에서 활약한 유명한 프랑스 장군
장 시메옹 샤르댕: 18세기 프랑스의 화가
장 주네: 실존주의파에 속하는 프랑스의 시인, 소설가, 극작가
장 아누이: 프랑스의 극작가
오귀스탱 장 프레넬: 프랑스의 물리학자
장 실뱅 바이: 프랑스의 천문학자이자 웅변가
장 비고: 프랑스의 영화 감독
장 지로두: 프랑스의 극작가·소설가
장 레이: 벨기에의 정치인
앙투안 장 그로: 프랑스의 신고전주의 화가인 동시에 낭만주의의 선구자
장 아르프: 프랑스의 화가 및 조각가
장 르레: 프랑스의 수학자
장 2세: 프랑스의 왕
장 파리조 드 라 발레트: 몰타 기사단의 제49대 총장(1557년 8월 21일 ~ 1568년 8월 21일)
장 1세 드 부르봉 공작: 1410년부터 그가 사망할때까지 부르봉 공작
장 이시도르 아리스프: 프랑스 혁명전쟁 및 나폴레옹 전쟁 기간동안 활약한 프랑스 장군
장 가스통 다르부: 프랑스의 수학자
장 지로: 뫼비위스(Mœbius)라는 필명으로 잘 알려진 프랑스의 만화가
장 프루아사르: 프랑스어를 사용한 저지대 국가 출신의 연대기 작가겸 궁정 역사가
아이리스 장: 중국계 미국인 역사가이자 작가
캐럴라인 장: 중국계 미국인인 피겨 스케이팅 선수
장 보댕: 프랑스의 종교 개혁기의 법학자이자 사상가
장 드 라브뤼예르: 프랑스의 모랄리스트
장 지글러: 스위스의 사회학자
장 4세 다르마냐크 백작: 1418년부터 1450년까지의 아르마냐크, 페젠사크, 로데스의 백작
장 드쿠: 1940년 7월부터 1945년 3월 9일까지 프랑스 비시 정부를 대표하는 프랑스령 인도차이나의 총독이었던 프랑스 해군 제독
장 팅겔리: 스위스 현대 조각을 대표하는 예술가이자 키네틱 아트(kinetic art), 누보레알리즘(nouveau réalism: 신사실주의) 예술가
장 벨리보: 캐나다의 아이스하키 선수
장 빌라르: 프랑스의 연출가 및 배우
장 도미니크 보비: 프랑스의 잡지 편집자
장 프랑수아 카르토: 프랑스 화가에서 프랑스 혁명군의 장군이 된 사람
장 랑게뉘: 벨기에의 축구 심판
장 5세 다르마냐크 백작: 아르마냐크의 백작
장 푸케: 르네상스 시기에 활동한 프랑스의 화가
장 핑: 가봉의 외교관, 정치인
장 조르카에프: 폴란드계 프랑스의 전 축구 선수
데이비드 장: 한국계 미국인 요리사
장 샬그랭: 프랑스의 건축가
장 막시밀리앙 라마르크: 프랑스의 장군
장 드 부르고뉴 (1415년): 프랑스의 귀족
장 뷔리당: 유럽에서 코페르니쿠스 혁명의 기반을 닦은 프랑스의 신부
장 바니에: 캐나다의 철학자이자 신학자, 운동가
장 조르주 노베르: 18세기 프랑스의 발레 안무가
장 8세 드 방돔 백작: 1466년부터 사망할때까지의 방돔 백작
샤를 장 바티스트 상송: 프랑스의 사형집행인
시몽 앙투안 장 륄리에: 프랑스 출신의 스위스 수학자
장 1세 달랑송 공작: 프랑스의 귀족
장 2세 달랑송 공작: 장 1세 달랑송의 아들
장 부앵: 프랑스의 육상 선수
장 알렉상드르: 아이티의 축구 선수
장 이냐스 이지도르 그랑빌: 프랑스의 삽화가
장 구종: 프랑스 르네상스 시기의 건축가이자 조각가
장 그르니에: 프랑스의 철학자이자 작가
장 프랑수아 라파엘리: 프랑스의 사실주의 화가, 조각가, 판화가
장 루이 에르네스트 메소니에: 나폴레옹과 그와 관련된 전쟁, 군대 등을 다룬 작품으로 유명한 프랑스의 고전주의 화가, 조각가
장 카수: 프랑스의 시인 · 소설가 · 비평가
장 지오노: 프랑스의 작가로 첫 작품 '언덕'을 발표하여 주목을 받았고 이 후 30여편의 소설과 에세이 그리고 시나리오를 쓴 인물
장 3세 다르마냐크 백작: 1384년부터 1391년까지의 아르마냐크, 페젠사크, 로데즈 백작
장 4세 드 리외: 브르타뉴의 귀족이자 사령관
장 4세 드 샬롱아를레: 오랑주 공작이자 아를레의 영주
장 르카뉘에: 프랑스의 정치인
장 피카르: 프랑스의 천문학자 겸 사제
장 도미니크 카시니 백작: 프랑스의 천문학자, 지도제작자였으며 세자르 프랑수아 카시니 드 튀리의 아들
장 마리 동구: 카메룬의 축구 선수
장 니코드: 프랑스의 철학자이자 논리학자
장 앙리 쥐베르: 알자스 출신의 풍경화가
피에르 장 조르주 카바니스: 프랑스의 생리학자, 프리메이슨 유물론적 철학자
주주 장: 미국의 저널리스트
장 2세 달브레 백작: 페리고르 백작, 리모주 자작
장 니코: 프랑스의 외교관이자 학자
장 지로 (영화 감독): 프랑스의 영화 감독이자 각본가
장 랑글레: 프랑스의 작곡가이자 오르간 연주자
장 에슈노즈: 프랑스의 소설가
장 아메리: 오스트리아의 작가
장 마비용: 프랑스의 베네딕트 수도회 수도사이자 사학자, 고문서학자
장 구노: 프랑스의 체조 선수
피에르 드 장 올리비: 프랑스의 프란치스코회 수도사, 신학자
장 폴 폰데르부르크: 스웨덴의 축구 선수
장 사블롱: 부드러운 창법으로 '프랑스의 빙 크로스비'로 불리는 남성가수
장 뷔로: 백년 전쟁 말년에 주로 활동했던 프랑스의 포병 사령관
장 드 틸레: 프랑스 가톨릭 주교
케이티 장: 한국계 미국인 배우
장 미셸 쿨롱: 프랑스에서 태어난 화가
장 도세
장 르 롱 달랑베르
장 1세 (프랑스)
장 달브레
장 르노
장 라신
장 드 뒤누아 백작
장 피에르 폴나레프
장 크리스토프 나폴레옹
장 1세 드 라마르슈 백작
장 도말리우스 달로이
장 바티스트 드 라 살
장 1세
장 드 부르고뉴
장 도를레앙
쟝 스쿠데리: 프랑스 비주얼 아티스트
쟝 폴 루시욜: 프랑스의 연극 배우, 영화배우, 텔레비전 배우

가공의 인물
장 발장: 프랑스의 소설가 빅토르 위고가 1862년 발표한 장편소설 《레 미제라블》에 나오는 인물이며 소설의 주인공
장 키르슈타인: 진격의 거인의 등장인물
장 로크 라르티그: 신비한 바다의 나디아의 등장인물