조지는 다음 뜻으로 쓰인다.

인명
조지(George)는 영어 이름이다.
클라란스의 조지
영국의 왕
영국의 조지 1세
영국의 조지 2세
영국의 조지 3세
영국의 조지 4세
영국의 조지 5세
영국의 조지 6세
영국의 조지 왕자
헨리 조지는 미국의 경제학자이다.
조지 워싱턴은 미국의 초대 대통령이다.
조지 H. W. 부시는 미국의 제41대 대통령이다.
조지 W. 부시는 미국의 제43대 대통령이다.
조지 레이코프는 미국의 인지언어학자이다.
조지 클루니: 미국의 영화 감독이자 배우
조지 웰스 비들: 미국의 유전학자
조지 마셜: 미국의 군인·정치가
조지 버나드 쇼: 아일랜드의 극작가 겸 소설가이자 수필가, 비평가, 화가, 웅변가
조지 오웰: 인도에서 태어난 영국 작가이자 언론인
조지 스무트: 미국의 천체 물리학자
조지 해리슨: 영국의 기타 연주자
조지 마틴: 영국의 음악 프로듀서
조지 웨아: 라이베리아의 정치인, 전 축구선수
조지 리처드 마이넛: 미국의 의학자
조지 마이클: 잉글랜드의 싱어송라이터
조지 데이비스 스넬: 미국의 유전학자, 면역학자
조지 E. 스미스: 미국인 응용 물리학자
조지 패짓 톰슨
조지 포터: 영국의 화학자
조지 에밀 펄레이드: 루마니아 출신의 미국의 세포생물학자
조지 베스트: 북아일랜드의 전 축구 선수
조지 월드: 미국의 생물학자, 신경과학자
조지 앤드루 올라: 헝가리 왕국 출신의 미국의 화학자
조지 H. 히칭스
조지 호이트 휘플: 미국의 병리학자, 생물학자, 의학자
조지 브렛: 메이저 리그 캔자스시티 로열스에서 3루수 등으로 뛴 야구 선수
조지 루카스: 미국의 영화 제작자이자 기업가
조지 P. 스미스: 미국의 화학자
조지 고든 바이런: 영국의 시인
로널드 조지 레이퍼드 노리시: 영국의 화학자
조지 켈: 미국의 전 야구 선수
조지 C. 스콧: 미국의 배우
무라타 조지: 일본의 전 프로 야구 선수이자 야구 지도자, 야구 해설가·평론가
데이비드 로이드 조지: 영국의 정치가
조지 산타야나: 스페인 태생 미국의 철학자, 시인, 평론가
조지 버클리: 아일랜드의 철학자이자, 성공회 주교
조지 번스: 미국의 배우
조지 큐커: 미국의 영화 감독
조지 스티븐스: 미국의 영화 감독, 촬영 감독
마쓰오카 조지: 일본의 영화 감독
조지 애컬로프: 미국의 경제학자
조지 로이 힐: 미국의 영화 감독
조지 알리스: 잉글랜드의 배우
조지 앨티도어: 미국의 축구 선수
조지 시걸: 미국의 배우
조지 링컨 록웰
헨리 조지: 미국의 저술가, 정치가, 정치경제학자
제1대 스토크스 준남작 조지 스토크스
조지 스티글러: 미국의 경제학자
조지 메이슨: 미국의 정치인
조지 가모프: 러시아 출신의 미국 천문학자
조지 밀러: 오스트레일리아의 영화 감독
조지 클린턴: 미국의 군인, 정치인
조지 웨스팅하우스: 미국의 발명가이자 사업가
조지 케네디: 미국의 배우
조지 거슈윈: 현대 음악이라 불리는 20세기 전반에 있어서 미국적인 성격과 수법을 가장 잘 발휘시켰다고 평가 받는 작곡가
조지 암스트롱 커스터: 남북 전쟁과 인디언 전쟁에서 기병대 사령관을 지낸 미국의 군인
조지 S. 패튼: 제2차 세계 대전 중인 1943년 ~ 1945년, 북아프리카, 시실리, 프랑스, 독일에서의 전투를 지휘한 미국의 육군 장군
조지 워싱턴 카버: 미국의 농학자
조지 M. 댈러스: 미국의 제11대 부통령(1845~49)
조지 비델 에어리: 영국의 천문학자이자 지구물리학자
조지 호츠: 미국의 해커
조지 샌더스: 잉글랜드의 배우
조지 미드: 남북 전쟁 당시 활약한 미국의 직업 군인이고, 여러 개의 등대를 포함한 해안 건설에 관여했던 토목기사
조지 로든: 자메이카의 전 육상 선수
조지 그렌빌: 영국 휘그당의 정치가로 총리(재임 : 1763년 4월 16일 - 1765년 7월 13일)
조지 매케이: 잉글랜드의 배우
조지 불: 영국의 수학자, 논리학자
켄트 공작 조지: 영국의 왕족
조지 피켓: 남북전쟁에서 남군쪽에서 활약한 장군
제1대 버킹엄 공작 조지 빌리어즈: 잉글랜드의 제임스 1세의 총신
조지 J. 미첼: 미국 메인주 상원 의원을 역임한 정치가이자 기업가
케임브리지 공작 조지: 영국의 왕족으로 조지 3세의 손자
조지 준드저: 미국의 배우
조지 휫필드
조지 레이전비: 오스트레일리아의 배우
조지 부시
조지 월리스: 미국의 정치인
요나시로 조지: 일본의 축구 선수
조지 코잭: 미국의 수영 선수로 올림픽 2관왕이자, 2개의 종목들(자유형, 배영)에서 세계 기록 보유자
조지 매클렐런: 미합중국의 군인, 정치가
조지 숄티: 헝가리 출신의 지휘자
조지 아미티지 밀러: 미국의 심리학자
조지 윌리엄스 (축구 선수): 웨일스의 축구 선수
조지 A. 로메로: 미국의 영화 감독, 영화 각본가, 영화 편집자, 배우, 작곡가
조지 밀러 (영화 감독): 오스트레일리아의 영화 감독 · 프로듀서 · 각본가
조지 케이: 잉글랜드의 축구 선수이자 루턴 타운, 사우샘프턴, 리버풀의 감독
제임스 조지 프레이저: 영국 스코틀랜드의 인류학자
조지 타케이: 미국의 배우, 감독, 작가, 운동가
조지 맥거번: 미국의 정치인
조지 엘리엇: 영국의 소설가, 시인, 언론인, 번역자이자 빅토리아 시대의 가장 중요한 작가 가운데 하나
가토 조지: 일본의 스피드 스케이팅 선수
조지 머피: 미국의 무용가이자 배우
조지 R. R. 마틴
조지 애시모어 피치: 미국의 선교사
조지 셀: 헝가리 태생의 미국의 지휘자
조지 호지슨: 20세기 초반에 나타난 캐나다의 수영 선수
조지 샐링: 미국의 허들 선수이자, 1932년 로스앤젤레스 올림픽 110m 허들 금메달리스트
조지 웰컴: 온두라스의 축구 선수이며 포지션은 공격수
조지 손: 잉글랜드 출신 프로 축구 선수
조지 (서진): 조위 ~ 서진의 관료
조지 마이컨: 미국의 농구 선수
조지 로페즈: 미국의 개그맨, 배우
피터 조지 (역도 선수): 미국의 역도 선수로 1952년 하계 올림픽에서 미들급 부문의 금메달을 획득하
조지 거빈: 은퇴한 미국 프로농구 선수
조지 쇼 (1880년)
제1대 암스트롱 남작 윌리엄 조지 암스트롱: 영국 출신의 발명가, 사업가
제1대 클래런스 공작 조지 플랜태저넷: 영국의 왕족
조지 갤러웨이: 영국의 정치인, 방송인, 작가
조지 스티븐슨: 영국의 발명가
찰스 조지 고든: 영국의 군인
제2대 밀포드 헤이븐 후작 조지 마운트배튼
조지 소로스: 헝가리계 미국인으로서 금융인이자 투자가
조지 맥크리디 프라이스: 제7일 안식교 출신의 캐나다의 창조주의자
조지 S. 로버트슨: 영국의 육상 선수이자 테니스 선수이며 고전학자, 변호사
조지 허버트 미드: 미국의 사회학자
조지 벤슨: 미국의 음악가, 기타리스트이자 작곡가
조지 맥카트니: 웨스트 햄 유나이티드에서 뛰고 있는 아일랜드의 축구 선수
조지 스프링어: 미국의 야구 선수로 메이저 리그에 소속되어 있는 휴스턴 애스트로스의 외야수
조지 데이비드 버코프: 미국의 수학자
조지 칼린: 미국의 스탠드업 코미디언, 영화 배우
조지 이스트먼: 이스트먼 코닥이라는 회사를 설립하고 롤 필름의 사용을 보급함으로써 사진 촬영을 주류로 이끄는데 기여한 미국의 기업가
조지 엘러리 헤일: 미국의 천문학자
존 조지 케메니: 미국의 수학자이자 컴퓨터 과학자
제1대 매카트니 백작 조지 매카트니: 영국의 외교관, 정치가
멀리사 조지: 오스트레일리아, 미국의 배우
조지 폭스: 퀘이커로 알려진 종교친우회(Religious Society of Friends)의 창시자이자 비국교도
조지 케넌: 미국의 고문, 외교관, 정치가, 역사가이며 '봉쇄의 아버지' 라고 잘 알려져 있으며 미소냉전의 핵심이 된 인물
조지 가르시아: 미국의 배우이자 코미디언
조지 페레스: 미국의 만화가
조지 아벨라: 전 몰타의 대통령
조지 밴쿠버: 영국의 탐험가
조지 페퍼드: 미국의 배우
조지 쇼 (생물학자): 잉글랜드의 식물학자이자 동물학자
제1대 로드니 남작 조지 브리지스 로드니: 영국의 제독
조지 프랫 슐츠: 미국의 교수, 사업가, 정치인이자, 60대 국무장관
브라이언 조지: 영국의 배우
조지 영 (음악가): 스코틀랜드 출신의 오스트레일리아의 록 음악가, 작곡가, 음악 프로듀서
조지 맬러리: 영국의 산악인
조지 윈스턴: 미국의 음악가
제1대 색빌 자작 조지 저메인
조지 댄치그: 미국의 수학자
조지 포먼: 현재 은퇴한 미국의 권투 선수
조지 해밀턴
조지 쇼: 영국의 기업인
조지 뉴번: 미국의 배우
조지 포지: 미국의 허들 선수로 1904년 하계 올림픽에서 2개의 동메달을 딴 아프리카계 미국인 최초의 올림픽 메달리스트
조지 갤럽: 미국의 통계학자
야나미 조지: 일본의 성우
조지 헨리: 잉글랜드의 배우
조지 워싱턴급 잠수함
조지 앨릭 에핀저: 미국의 SF 소설가
존 조지 헤이그: 영국의 연쇄 살인자
조지 프레보스트: 영국의 군인
조지 러즈: 미국 육군 101 공수사단 506 낙하산 보병 연대의 2대대였던 이지 중대의 부사관
윌리엄 조지 애스턴: 영국의 외교관, 작가이자 일본과 한국의 언어와 역사를 연구한 학자
조지 존스: 미국계 음악가, 가수, 작곡가
조지 래프트: 미국의 영화 배우
조지 앤슨: 영국의 해군 군인 · 정치가
조지 N. 질레트: 미국의 기업인
조지 손더스: 미국의 작가
조지 로버트 그레이: 왕립학회 소속 영국 동물학자
조지 루이스 지 올리베이라 주니오르: 브라질의 전 축구 선수
조지 헨리 크럼
조지 클레이턴 포크: 조선에 파견된 미국 공사관의 무관
성산 아토스의 조지
조지 애벗: 캔터베리 대주교
조지 와이스: 미국의 변호사, 판사, 저명한 법학자
조지 브라운: 캐나다의 기자, 정치인
조지 매큔
제이슨 윈스턴 조지: 미국의 배우
조지 웬트: 미국의 배우
조지 모스토: 미국의 수학자
조지 해밀턴 (배우): 미국의 배우
조지 시어링: 영국에서 태어난 재즈 피아노 연주자
조지 맥스웰 리처즈: 트리니다드 토바고의 정치인
조지 불로스: 미국의 수리논리학자이자 분석철학자
조지 뭉크: 잉글랜드의 귀족, 군인
조지 스미스
조지 영
조지 투포우 2세: 통가의 제2대 투포우(재위 : 1893 ~ 1918)
조지 스테퍼노펄러스: 미국의 전직 정치 고문이자 현직 언론인
보이 조지: 영국의 싱어송라이터다, 패션 디자이너, 사진 작가
조지 에버리스트: 영국의 수리지리학자이자 측량사, 군인, 탐험가
조지 벨로스: 미국의 현실주의 화가
조지 린드벡: 미국의 루터교 신학자이며 예일 대학교의 교수
조지 이즈: 미국의 배우
제5대 카나본 백작 조지 허버트: 영국의 금융인
조지 벡시: 뉴욕 타임스의 스포츠 칼럼니스트이자 비소설 저자
조지 톰슨 브라운
조지 맥도날드 처치: 미국 하버드 의학대학원의 교수
조지 리브스: 미국의 배우
오바라 조지: 일본의 기업인
조지 메러디스: 영국의 소설가 · 시인
조지 말스덴: 미국의 역사가이며 신학자
조지 롬니
조지 캐틀린: 미국의 화가이자, 작가이면서 여행가
조지 디카프리오: 미국의 만화가, 작가, 편집자로 미국 서해안의 메이저 언더그라운드 만화 배급업자
조지 프리드먼: 헝가리 태생의 미국 군사정치전문가
조지 힐: 싱글 스케이팅과 페어 스케이팅에 참가한 미국의 피겨 스케이팅 선수
조지 스트레이트: 미국의 컨트리 가수
조지 찰스 베리스퍼드: 빅토리아 여왕시대에 활동한 스튜디오 사진가
조지 피콕:
조지 펠: 오스트레일리아의 로마 가톨릭교회 추기경
조지 폼비: 영국의 배우이자 싱어송라이터
조지 애체롯: 링컨 대통령의 암살범인 존 윌크스 부스의 공범
조지 미첼: 미국의 기업인
조지 빌리어즈
조지 해리스 (배우): 잉글랜드의 배우
조지 우드브리지: 20세기 잉글랜드 출신의 배우
조지 베이커: 영국 잉글랜드의 영화배우 겸 시나리오 각본가
조지 아리요시: 미국의 정치인
조지 커즌
조지 십자장: 인명 구조 등에 있어서 매우 용감한 행위에 주어지는 영국의 십자 훈장
조지 셀던: 미국의 동화작가
조지 앨런 토머스: 영국의 배드민턴, 테니스, 체스 선수
조지 클린턴 (음악가): 미국의 음악가로 펑크 뮤직의 개척자 중 한 명
조지 W. 노리스: 미국의 정치인
조지 W. 롬니: 미국의 정치인이자 기업인
조지 셰릴: 미국 출신의 야구 선수
조지 스털츠: 미국의 배우
조지 매카트니
조지 모리슨: 19세기 영국의 외교관
조지 마셜 (육상 선수): 영국의 육상 선수
조지 하우: 영국군 준장
조지 터너 (예술가): 영국 풍경화가
조지 퍼타키: 미국의 변호사, 정치가
조지 타운센드
조지 켈리
조지 해리스
조지 투포우 1세: 통가의 초대 국왕
조지 샘프슨: 잉글랜드의 스트리트댄서 및 배우
조지 리처: 미국의 사회학자
조지 스틸: 미국의 전 프로레슬링선수
조지 박스: 영국의 통계학자
조지 메릿: 잉글랜드 출신의 배우
피터 조지: 다음을 가리킨다
조지 부캐넌: 스코틀랜드의 역사가
조지 알라기아: 스리랑카 출신의 영국 언론인
조지 아미스테드: 1812년 전쟁 동안 볼티모어 전투에서 맥헨리 요새의 사령관으로 복무를 했던 미국 민병대 장교
조지 킹슬리 지프: 미국의 언어학자이자 문헌학자
조지 먼로: 아일랜드-스코틀랜드계 영국 군인
조지 이즈라: 잉글랜드의 싱어송라이터
조지 스클러: 미국의 극작가다
윌리엄 조지 애덤스: 미국의 에스페란티스토
조지 롬니 (화가): 잉글랜드의 화가
조지 프레더릭 라이트
조지 알핫산: 가나 출신의 축구 선수
윈스턴 조지: 가이아나의 육상 선수
조지 P. 퍼트넘: 미국의 출판업자, 작가
프랜시스 조지: 미국의 로마 가톨릭교회 추기경
조지 머독: 미국의 문화인류학자
조지 몬커: 잉글랜드의 축구 선수
조지 해밀턴 (정치인): 캐나다의 정치인
조지 더 포앳: 영국의 시인, 래퍼
조지 가이: 미국의 생물학자
조지 캐널리: 미국의 전 야구 선수이자, 전 KBO 리그 현대 유니콘스의 외국인 선수
조지 시걸 (미술가): 미국의 조각가 · 화가
조지 엘로코비: 카메룬의 축구 선수
아이비 조지: 미국의 아역배우
조지 블래그든: 잉글랜드의 배우
조지 크리스토퍼 윌리엄스: 미국의 진화생물학자
조지 뷔치: 스위스의 유기화학자
헬렌 조지: 잉글랜드의 배우
조지 로리아: 조지아 프로 축구선수 선수
조지 스터브스: 말 그림으로 유명한 영국의 화가
고바야시 조지: 일본의 축구 선수
조지 쿠체: 남아프리카 공화국의 프로 골프 선수
조지 체벨리스
조지 B. 코텔류: 미국의 정치인
조지 앳치슨: 미국의 외교관
히사에다 조지: 일본의 외교관
조지 케일리: 영국의 엔지니어, 발명가, 비행사
조지 바나
알버트 조지 래섬: 현대 언어학 교수
조지 E. 베일런트: 하바드 의대 정신과 의사와 교수
조지 메테스키: 1940년대, 50년대 뉴욕 시 공공 장소에 폭탄을 설치하여 미친 폭탄마로 더 잘 알려졌던 사람
조지 클라크: 영국의 건축가, 작가, 방송인
조지 블레이크: 영국의 외교관
조지 포터 (배우): 잉글랜드의 배우
조지 런던 (동명이인)조지(棗祗, ? ~ ?)는 후한 말기의 관료이다.

가공의 인물
죠지 죠스타 - 만화 죠죠의 기묘한 모험의 등장 인물.
죠지 죠스타 1세 - 1부에서 등장하는 죠나단의 아버지.
죠지 죠스타 2세 - 죠나단의 아들, 2부에서 등장하는 죠셉의 아버지. 소설 죠지 죠스타의 주인공.
조지 오맬리: 숀다 라임스가 제작한 TV 드라마 《그레이 아나토미》의 등장인물

지명
조지 (남아프리카 공화국): 남아프리카 공화국 웨스턴케이프 주의 남동부에 있는 도시
미국
조지 (아이오와주)
조지 (워싱턴주)
서역의 조지

기타
조지는 일본의 연호이다.
조지(長治, 1104년 ~ 1105년)는 일본 헤이안 시대의 연호이다.
조지(貞治, 1362년 ~ 1367년)는 일본 남북조 시대 북조의 연호이다.
외로운 조지는 최후의 수컷 핀타섬땅거북이다.

같이 보기
조오지