조제는 다음을 가리킨다.

조제(調劑)는 약을 짓는 학문을 가리킨다.
조제: 조제는 대한민국의 영화이다.
조제, 호랑이 그리고 물고기들

인명
조제(José)는 포르투갈어, 에스파냐어 이름이다.
조제(趙弟, ? ~ ?)는 전한 중기의 관료이다.
조제(調製)는 주문 제작을 가리킨다.
조제 모리뉴: 포르투갈의 축구 감독
조제 하무스 오르타
조제 에두아르두 두스산투스: 앙골라의 독립운동가
조제 보베: 프랑스 altermondialisme의 대표적 운동가
세바스티앙 조제 드 카르발류 이 멜루 제1대 폼발 후작
호물루 조제 파셰쿠 다 시우바
조제 폰트: 포르투갈의 축구 선수
조제 카를루스 토폴루 주니오르: 흔히 알레망(포르투갈어: Alemão)으로 불리는 브라질의 축구 선수
주시마르 조제 테이셰이라: 짧게 알레망(포르투갈어: Alemão)라고도 불리는 브라질의 축구 선수
조제 보싱와: 포르투갈 출신의 옛 축구 선수
조제 호베르투 호드리게스 모타: 흔히 조제 모타, 또는 스페인어식으로 호세 모따로 불리는 브라질의 스트라이커
조제 호도우푸 피리스 히베이루: 도도(포르투갈어: Dodô)라고도 알려져있는 브라질의 축구 선수
조제 사르네이: 브라질의 정치인
조제 마누엘 두랑 바호주: 포르투갈의 정치인
조제 카를루스 페헤이라 필류: 제 카를루스(Zé Carlos)로 잘 알려진 브라질 마세이오 출신의 축구 선수
조제 모라이스: 포르투갈의 전 축구선수이자 축구감독
하파에우 조제 보티: 흔히 보티라는 이름으로 알려져 있는 브라질의 축구 선수
조제 카리오카: 브라질의 속어로 리우데자네이루 시 사람
조제 소크라트스
조제 파그네르 시우바 다 루스: 간단히 파그네르로도 불리는 브라질의 축구 선수
조제 시드: 포르투갈의 가수이자 작곡자
조제 아우미르 바호스 네투: 아우미르로 불리는 아르헨티나계 브라질 국적의 축구 선수
조제 핀투: 포르투갈어권과 스페인어권에서 사용하는 이름
에우바우두 조제 지 아기아르 네투
조제 알렝카르: 브라질의 정치인
조제 아우두: ufc페더급의 초대 챔피언
조제 마우루 지 바스콘셀루스: 브라질의 소설가로, 《나의 라임 오렌지나무》의 작가
조제 파질랴: 브라질 출신의 영화 감독, 영화 제작자
조제 세하: 브라질의 정치인
조제 그라지아노 다 시우바: 전 브라질 식량안보 장관
다비 조제 시우바 두 나시멘투: 브라질의 축구 선수
조제 에두아르두 카르도주: 브라질의 변호사이자 정치인
조제 히카르두 두스 산투스 올리베이라: 히카르지뉴(포르투갈어: Ricardinho)로 불리는 브라질의 축구 선수
조제 세바스티앙 피레스 네투
조제 아폰수: 포르투갈의 가수 겸 작곡가
조제 아이우통 다 시우바: 브라질의 축구 선수
조제 루이스 페이쇼투: 포르투갈의 작가