진은 다음 여러가지 뜻을 갖고 있다.

중국, 한국의 나라
행정
진(鎭)은 군사상 필요에 따라 설치한 행정 구획이다.
진(鎮)은 중화민국 및 중화인민공화국의 행정 구역의 일종이다.
진(津)은 강가 또는 바다가의 나루터이다. 도(渡)로 쓰기도 한다.

음악·문화
진(JIN-仁)은 일본의 만화, 드라마이다.
진(Jinn)은 일본의 락 밴드이다.
眞: 한국의 2007년 영화 작품

기업
진(Sinn)은 독일의 시계 제조업체이다.

인명
진은 성씨이다.
진(1990 ~ )은 일본의 음악가, 음악 프로듀서, 작곡가, 소설가, 각본가이다.
진(김석진, 1992 ~ )은 대한민국의 보이 그룹 방탄소년단의 일원이다.
진(박영진, 1995 ~ )은 대한민국의 보이 그룹 MVP의 일원이다.
JIN(박명은, 1996 ~ )은 대한민국의 걸 그룹 러블리즈의 일원이다.
진 해크먼: 미국의 배우
진 시몬스 (배우): 잉글랜드의 배우
빌리 진 킹: 은퇴한 미국의 프로 테니스 선수
진 켈리: 미국의 배우, 영화 감독, 안무가
하워드 진: 가난한 조선소 노동자 출신의 역사학자, 정치학자, 사회비평가, 사회운동가, 희곡 작가
진 할로: 미국의 배우이자 섹스 심벌
진 스테이플턴: 미국의 배우
진 허숄트: 덴마크의 배우
아카니시 진: 일본의 가수 겸 배우이며 남성 아이돌 그룹 KAT-TUN의 전 멤버
진 마시: 잉글랜드의 배우
진 로든베리: 미국의 텔레비전, 영화 작가, 그리고 미래학자
진 콜런: 미국의 만화책 아티스트
진 실리: 미국의 높이뛰기 선수
진 스마트: 미국의 배우
코바야시 진: 일본의 만화가
진 아서: 미국의 배우
진 트리플혼: 미국의 배우
진 폴 게티: 미국의 사업가
진 헤이건: 미국의 배우
진 시버그: 미국의 배우
진 유 프레이: 미국의 종합격투기 선수로 한국계 미국인
진 오트리: 미국의 싱어송라이터, 기타 연주자, 음반 프로듀서, 영화배우, 영화연출가, 야구기업가
진 바틱: 에니악 컴퓨터의 프로그래머 중 한 명
도몬 진: 일본의 남자 성우
진 크랜츠: 미국의 항공 우주 엔지니어
진 세구라: 도미니카 공화국의 야구 선수이자, 현재 내셔널 리그 필라델피아 필리스의 선수
하나토 진: 일본의 축구 선수
진 리스: 도미니카의 소설가
진 룬 양: 미국의 만화 스토리 작가
진 웹스터: 미국의 아동 문학가
진 슈림프턴: 잉글랜드의 모델
진 섀힌: 미국 민주당 소속의 정치인
진 색스: 미국의 배우, 영화 감독
시라스 진: 일본의 배우
진 스니츠키: 미국의 프로레슬링선수
진 시몬스 (음악가): 미국의 음악가
세라 진 언더우드: 미국의 모델
진 하: 한국계 미국인
진 맥아더: 미국의 여행가 겸 기행작가이자 수필가 겸 문필가이며 사회운동가 및 개신교 장로회 신자
진 윤: 캐나다의 배우
사토 진: 일본의 축구 선수
진 히그진스: 에미상을 받은 경력이 있는 미국의 텔레비전 및 영화 감독
진 암달: 미국의 컴퓨터 공학자이자 기업가
센본마쓰 진: 코나미(코나미 디지털 엔터테인먼트)의 음악 게임(비마니(BEMANI) 시리즈)의 작곡가
루카스 진: 현재 볼란치로 활동하는 브라질의 축구 선수
진 브루스 스콧: 미국의 배우
리비 진: 캐나다의 가수
고야마 진: 前 KBO 리그 kt 위즈의 트레이닝 코치
니키 진: 미국의 싱어송라이터
진 위그모어: 뉴질랜드의 싱어송라이터
커샌드라 진: 미국의 배우, 모델
진 브룩스: 미국의 배우, 가수
핫포비 진: 일본의 일러스트레이터
이즈미사와 진: 일본의 축구 선수
제임스 진: 타이완계 미국인 미술가
진 유키
진 지첸
진 시몬스
진 와일더
진 빈센트
진 티어니
마쓰바라 진

가공의 인물
진(陣)은 유유백서의 등장인물이다.
진은 니코니코 동화의 관련 인물이다.
콰이곤 진: 영화 《스타 워즈 시리즈》의 등장인물
진 그레이: 마블 코믹스 세계관에 등장하는 등장인물
진 어소: 2016년 영화 《로그 원》에서 잉글랜드의 배우 펠리시티 존스가 연기한 《스타 워즈》 프랜차이즈의 가공의 인물
카자마 진
진: 브롤스타즈 신화 캐릭터

그 외
진(gin)은 술의 하나다.
진(jinn)은 아랍의 '영귀'적 존재를 말한다.
진(津)은 천연 수지이다.
진(軫)은 별자리의 하나이다.
진(辰)은 지지의 다섯째이다