짐은 다음 여러가지 뜻을 가진다.

일반 의미
짐(朕)은 임금이 자기 자신을 가리킬 때 쓰는 1인칭 대명사이다.
짐은 옮기기 위해 꾸려 둔 물건이다.

인명
짐(Jim)은 제임스의 애칭이다.
짐 브로드벤트: 잉글랜드의 배우
짐 더건
짐 캐리: 캐나다 출신으로 주로 미국에서 활동하는 배우 겸 코미디언
짐 나이드하트: 캐나다의 프로레슬링선수
짐 로스: 미국의 남자 전 프로레슬링선수, 스포츠해설자
짐 셰리던: 아일랜드의 영화 감독이자 각본가
짐 토미: 미국의 전 야구 선수
짐 커밍스: 미국의 성우
짐 라이트바디: 미국의 중거리달리기 선수
짐 클라크: 영국 스코틀랜드의 자동차 경주 선수
짐 래시: 미국의 배우
짐 몽고메리: 미국의 수영 선수
짐 하인스: 미국의 육상 선수
짐 파슨스: 미국의 배우
짐 테이텀: 전 KBO 리그 LG 트윈스의 외국인 선수
짐 자무시: 미국의 영화감독이자 배우
짐 커비즐: 미국의 배우
짐 프라이어: 영국 보수당 당원인 정치인
짐 스터게스: 잉글랜드의 배우 및 싱어송라이터
짐 리: 대한민국 서울에서 출생한 한국계 미국 만화가
짐 팩: 캐나다의 아이스하키 선수이자 현재는 대한민국 아이스하키 국가대표팀의 감독
짐 브라운: 미국의 전직 미식축구 선수 및 배우
짐 러벨: 미국의 군인이자 우주비행사
짐 볼저: 뉴질랜드의 정치인
짐 헨슨: 미국의 인형극가
짐 카터: 잉글랜드의 배우
짐 비버: 미국의 배우
짐 스탈린: 미국의 만화가
짐 데이비스 (만화가): 미국의 만화가
짐 바니: 미국의 배우
짐 월리스: 미국의 진보적인 기독교 출판인, 작가, 활동가
짐 홀: 미국의 재즈 기타리스트, 작곡가, 편곡가
짐 톰프슨: 미국의 디자이너
짐 패랙: 미국의 배우
짐 캐시: 탑 건, 나의 성공의 비밀과 같은 1980년대 영화 작품을 각본한 것으로 저명한 영화 작가
짐 크로치: 미국의 가수
짐 오루크: 아일랜드계 미국인 음악가이자 음반 프로듀서
짐 리시: 미국의 정치인
짐 청: 영국 출신의 만화가
짐 매캔: 아일랜드의 포크 가수이며 뮤지컬 배우
짐 웨브: 미국의 정치인
골즈 짐: 미국의 헬스클럽 체인
짐 애벗: 미국의 야구 선수
짐 존스 (래퍼): 미국의 래퍼
짐 피터스 (육상 선수): 영국의 육상 장거리 선수
짐 콜린스: 미국의 경영 컨설턴트
짐 로저스: 미국의 사업가이며 싱가포르에서 거주하는 재정 분석가
짐 다인: 미국의 팝 아티스트
짐 베라로스: 미국의 가수이자 배우
힐리빌리 짐: 미국의 남자 프로레슬링선수
짐 톰프슨 (디자이너)
짐 톰프슨 (작가): 미국의 소설가
짐 모라: 뉴질랜드의 미디어 진행자

가공의 인물
짐 레이너: 블리자드 엔터테인먼트의 비디오 게임 시리즈 《스타크래프트》에 등장하는 주인공

기타
짐(鴆)은 전설 속의 새 이름이다
짐(Zim)은 이스라엘의 해운 회사이다.
짐(ج)은 아랍 문자의 다섯번째 글자이다.
짐(gym)은 피트니스 클럽, 체육관, 도장을 지칭하는 말이다.
짐(GM)은 애니메이션 기동전사 건담에 등장하는 병기이다.

같이 보기
ZIM