카라(Kara, Khara, Cara, Carra 등)는 다음 뜻으로 쓰인다.

미디어
음악
카라 : 대한민국의 걸그룹

영화
카라 (영화) (Calla): 1999년에 개봉한 대한민국의 영화
카라 영화제 (Kara Film Festival): 파키스탄의 카라치에서 열리는 국제적인 영화제

기타
카라 (스튜디오) (カラー): 일본의 애니메이션 제작 회사

인명
카라 (만화가): 대한민국의 만화가
알레시아 카라: 캐나다의 싱어송라이터
카라 디오가디: 미국의 가수 겸 작곡가이자 음악 프로듀서
카라 델레바인: 잉글랜드의 모델, 배우, 가수
카라 블랙: 짐바브웨의 테니스 선수
데버러 카라 엉거: 캐나다의 배우
아이린 카라: 미국의 싱어송라이터 및 배우
카라 무스타파 파샤: 오스만 제국의 재상
카를로 카라: 이탈리아의 화가
카라 시오볼드: 잉글랜드의 배우
카라 부오노: 미국의 배우, 각본가, 영화 감독
카라 매컬로: 미국의 물리 과학자, 미인대회 우승자
카라 토인턴: 잉글랜드의 배우
재스민 카라: 스웨덴의 가수
세실리아 카라: 프랑스의 배우, 가수
신 카라 (동명이인)

지명
카라 해 (Kara Sea): 북극해의 해역
카라 해협 (Kara Strait): 러시아의 해협
카라 섬 (Cara Island): 스코틀랜드의 섬
카라 분화구 (Kara Crater): 러시아에 있는 유성 분화구
카라 주 (Région de la Kara): 토고의 주
카라 (토고) (Kara): 카라 주에 있는 마을
카라 (네팔) (Khara): 네팔의 마을
카라 (인도) (Kara): 인도의 마을
카라 (파키스탄) (Khara): 파키스탄의 마을

신화
카라 (북유럽 신화) (Kára): 발키리의 한 명
카라 (인도 신화) (Khara): 인도의 서사시 《라마야나》에 등장

단체
카라 (단체) (Korea Animal Rights Advocates, KARA): 대한민국의 동물 보호 단체
KARA (Korea Automobile Racing Association): 문화체육관광부 산하의 사단법인 공익단체

민족
카라족 (남수단) (Kara): 남수단의 민족
카라족 (탄자니아) (Kara): 탄자니아 우케레웨 섬의 민족

군사
카라급 순양함 (Kara Class Cruiser): 러시아의 군함
카라 (전차): 이란의 주력전차

기타
깃의 다른 용어
카라 (항성) (Chara): 사냥개자리에서 두 번째로 밝은 항성
카라 (시크교) (Kara): 시크교도의 팔찌
카라어 (Kara language): 파푸아뉴기니 뉴아일랜드 섬에서 쓰이는 언어

같이 보기
카라스 (동음이의)
칼라 (동음이의)
컬러 (동음이의)