페이는 다음과 같은 뜻이 있다.

페이(Fay)는 요정을 의미한다.
페이(pay)는 임금이나 급여를 말한다.
페이(pay)는 변제 과정을 가리킨다.

인명
페이(본명: 王霏霏, 왕페이페이, 1987 ~ )는 중국의 가수로, 대한민국의 음악 그룹 미쓰에이의 멤버이다.
페이 더너웨이: 미국의 배우
티나 페이: 미국의 작가이며 희극 배우
페이 베인터: 미국의 배우, 가수
페이 그랜트: 미국의 배우
제마 페이: 스코틀랜드의 전 여자 축구 선수
페이 레이: 캐나다의 여배우
케라 페이 차노: 미국의 싱어송라이터
미건 페이: 미국의 배우
페이 마세이: 잉글랜드의 배우
줄리아 페이: 미국의 배우
페이 레이건: 미국의 포르노 배우
마이클 페이: 1994년 싱가포르에서 공공 기물 등을 훼손하는 등의 죄로 태형(笞刑)을 선고받았던 미국인
I. M. 페이: 중국계 미국인 건축가

가공의 인물
모건 르 페이: 아서왕 전설의 인물

컴퓨터 과학, 기술
구글 페이: 구글이 개발한 전자지갑 플랫폼의 하나
LG 페이: LG전자가 제공하는 모바일 결제 및 전자지갑 서비스
삼성 페이: 삼성전자에서 만든 모바일 결제 서비스
애플 페이: 애플이 제공하는 모바일 결제 및 전자 지갑 서비스
아마존 페이: 아마존 소유의 온라인 지불 서비스
마이크로소프트 페이: 마이크로소프트가 제공하는 모바일 결제 및 전자지갑 서비스

기타
페이(Faye)는 1995년 폭풍이다.