폴은 다음과 같은 뜻이 있다.

폴(Pole)은 스포츠 용품에서 막대기 따위를 말한다.
폴(Paul)은 베이커리 전문점이다.
폴댄스(Pole Dance)

영화
《황당한 외계인: 폴》은 2011년 영화이다.

인명
폴(Paul)은 남성의 이름이다.
폴 파레: 프랑스의 지휘자, 작곡가
폴 로브슨: 미국의 베이스 바리톤 콘서트 아티스트이자 영화 배우
폴 디랙: 영국의 이론물리학자
폴 뉴먼: 미국의 배우, 영화 감독, 기업가, 인도주의자, 카레이서
폴 지어마티: 미국의 배우
폴 너스: 영국의 생물학자
폴 라우터버: 미국의 화학자
폴 그린가드: 미국의 신경과학자
폴 D. 보이어
폴 플로리: 미국의 물리화학자
폴 포트: 캄보디아의 독립운동가, 노동운동가, 군인, 정치인이자 공산주의 혁명가
폴 워너: 미국의 전 야구 선수
폴 런던: 미국의 프로레슬링선수
폴 L. 모드리치: 미국의 생화학자
폴 오텔리니: 인텔의 전 사장
폴 버그: 미국의 생화학자
폴 사바티에: 1912년에 빅토르 그리냐르와 함께 노벨 화학상을 공동 수상한 프랑스의 유기화학자
폴 무니: 미국의 배우
폴 S. 켐프: 미국의 소설가이며 스타워즈에 소설가
폴 포그바: 프랑스의 축구 선수
폴 루커스: 미국의 배우
루시드 폴: 대한민국의 가수・작가・번역가・농부
폴 토머스 앤더슨: 미국의 영화 감독이자 각본가, 영화 프로듀서
폴 스콜스: 잉글랜드의 은퇴한 축구 선수
폴 코언: 미국의 수학자
폴 사이먼: 미국의 싱어송라이터
폴 앨런
폴 로머: 미국의 경제학자이자 뉴욕 대학교의 교수
폴 앙리 디트리히 돌바크 남작: 18세기의 프랑스의 계몽사상가
폴 새뮤얼슨: 미국 신고전파 경제학자
폴 크루그먼: 미국의 지식인, 경제학자, 컬럼니스트, 작가
폴 틸리히: 독일의 신학자이자 루터교 목사
폴 호건: 오스트레일리아의 배우이자 희극인
폴 베를렌: 프랑스의 시인
폴 라파르그: 19세기에 프랑스에서 주로 활동했던 사회주의자
폴 그린그래스: 잉글랜드의 영화 감독
폴 데이노: 미국의 배우, 영화 감독
폴 리쾨르: 프랑스의 철학자
폴 그라이스: 영국 및 미국의 언어철학자
알리스 폴: 프랑스의 배우
폴 베어러: 전 미국의 프로레슬링 선수
폴 인스: 잉글랜드의 전 축구 선수이자 축구 감독
폴 해기스: 캐나다의 영화 감독, 각본가이자 제작자
폴 니장: 프랑스의 소설가, 철학가이자 저널리스트
폴 세잔: 프랑스의 대표적 화가로서 현대 미술의 아버지
폴 몰리터: 미국 출신의 전 메이저 리그의 선수
폴 개스코인: 잉글랜드의 축구 선수이자 감독
폴 아서스: 영국의 음악가
폴 헤이먼: 미국의 남자 프로레슬링의 매니저
폴 레노: 프랑스의 정치인, 변호사
폴 고갱: 프랑스의 후기인상주의 화가
폴 두메르: 프랑스의 정치가, 제14대 대통령
폴 로빈슨 (1979년): 잉글랜드의 전 축구 선수
폴 팽르베: 프랑스의 수학자 겸 정치가
폴 러드: 미국의 배우 겸 코미디언, 영화 제작자, 각본가
폴 처칠랜드: 신경철학 연구와 정신철학 연구로 유명한 캐나다의 철학자
폴 베터니: 잉글랜드의 배우
폴 해링턴: 아일랜드의 가수
폴 맥기건 (음악가): 영국의 음악가이며 영국의 록 밴드 오아시스의 설립자 4명 중 한 명
폴 라마디에: 프랑스의 정치인
폴 르구엔: 프랑스의 축구 선수이자 축구 지도자
폴 맥셰인: 아일랜드의 축구 선수
폴 영: 잉글랜드의 가수
폴 슈레이더: 미국의 영화 감독, 영화 각본가, 영화 평론가
숀 폴: 자메이카의 랩 가수 겸 레게 음악 가수
폴 디애노: 영국의 싱어송라이터
폴 킴 (1988년): 대한민국의 가수
폴 마틴: 캐나다의 정치인
폴 포츠: 영국의 성악가이자 가수
폴 워커: 미국의 배우
폴 드레이턴 (육상 선수): 미국의 육상 선수
로버트 폴: 캐나다의 피겨 스케이팅 선수
크리스 폴: 1985년 5월 6일 출생의 미국인 프로 농구선수
폴 더밋: 잉글랜드 태생의 웨일스 축구 선수
존 폴 존스 (음악가): 영국의 베이시스트이자 작곡가
헤리에스 폴: 캐나다의 모델
폴 램버트: 스코틀랜드의 전 축구 선수이자 현 감독
폴 시냐크: 프랑스 파리 출생의 화가
폴 랑주뱅: 프랑스의 물리학자
폴 카가메: 르완다의 정치인이자 군인
폴 허시: 미국의 영화 편집 기사
폴 블랙번: 미국 프로야구 아메리칸 리그 오클랜드 애슬레틱스의 선수
폴 W. S. 앤더슨: 잉글랜드의 영화 감독
폴 비야: 카메룬의 대통령
폴 앵카: 캐나다에서 태어난 미국의 싱어송라이터 겸 영화 배우
폴 에렝: 전 케냐의 육상 선수
폴 키팅: 오스트레일리아의 정치인
폴 코너코: 미국 프로 야구 시카고 화이트삭스의 선수
폴 피에르 레비: 프랑스의 수학자
폴 와이츠: 미국의 영화 제작자
폴 맥기건: 영국의 음악가
폴 라이언: 미국의 정치가
폴 바라스: 프랑스 혁명기의 정치가, 군인
폴 펠리오: 프랑스인 중국학자
에런 폴: 미국의 배우
폴 오닐: 전 메이저 리그 베이스볼에서 활약한 외야수(우익수)
폴 소비노: 미국의 배우
폴 티베츠: 제2차 세계 대전기의 미국 공군에서 매우 유명한 조종사 중 한 사람
폴 피그: 미국의 배우, 영화 감독, 영화 각본가
폴 러페이지: 미국 공화당 소속의 정치인
폴 클로델: 프랑스의 외교관이자 시인
폴 맥갠: 잉글랜드의 배우
폴 세레노: 미국의 고생물학자이자 시카고 대학의 교수
폴 윈필드: 미국의 배우
클라우디아 폴: 코스타리카의 수영 선수이자, 국내 기록 보유자
폴 마송: 프랑스의 사이클 선수다
비니 폴: 헤비 메탈 밴드 판테라의 드러머 겸 공동창업자로 가장 잘 알려진 미국의 음악가, 작곡가, 프로듀서
폴 오스터: 미국의 소설가
폴 디니: 미국의 만화가, 애니메이터
폴 둘리: 미국의 배우
폴 루번스: 미국의 배우이자 희극인
폴 라이저: 미국의 배우
빈첸시오 드 폴: 프랑스의 로마 가톨릭 사제
폴 뒤카스: 프랑스의 작곡가
폴 캐머런: 캐나다 출신의 영화 촬영 기사
폴 길버트: 미국의 가수 겸 기타리스트
폴 그린: 미국의 극작가
폴 길포일: 미국의 배우
폴 발레리: 프랑스의 시인·사상가·평론가
폴 볼커: 미국의 경제학자
레스 폴: 미국의 기타리스트이자 솔리드 바디 일렉트릭 기타를 만든 사람
폴 케이시: 《닥터 후》, 《사라 제인 어드벤처》, 《토치우드》에서 괴물 역을 자주 맡은 잉글랜드의 배우
폴 엘뤼아르: 프랑스의 시인
폴 브로카: 프랑스의 외과 의사, 신경학자, 해부학자, 인류학자
진 폴 게티: 미국의 사업가
폴 글리슨: 미국의 배우
폴 마저스키: 미국의 영화 감독이자 배우
폴 스탠리: 미국의 음악가
폴 화이트먼: 미국의 가수
프레더릭 폴: 미국의 과학 소설 작가이자 편집자
딘 폴 마틴: 미국의 군인, 테니스 선수, 가수, 작사가, 영화배우이며 예비역 미국 육군 대위
폴 아델스타인: 미국의 배우
폴 슬로윈스키: 폴란드계 오스트레일리아인
폴 리비어: 미국의 은세공
폴 웰러: 1958년 5월 25일에 태어난 영국의 싱어송라이터
존 폴 스티븐스: 미국 연방대법원의 전직 대법관
론 폴: 미국의 정치인이자 예비역 미국 육군 군의관 중위
폴 터갓: 케냐의 장거리 달리기 선수
폴 인 러브: 다음을 의미한다
폴 브레머: 미국의 정치인
폴 로빈슨: 영어권에서 사용하는 이름
폴 버처: 미국의 배우
폴 스파크스: 미국의 배우
폴 캔트너: 미국의 록 음악가, 기타리스트이자 가수
폴 프리먼: 잉글랜드의 배우
폴 챔버스: 미국의 재즈 더블 베이스 연주자
폴 왁타 사보이: 노르웨이의 음악가
폴 화이트하우스: 웨일스의 배우
그레고리 S. 폴: 미국의 프리랜서 고생물학자, 저술가, 일러스트레이터
폴 데즈먼드: 미국의 재즈 색소폰 연주자이자 작곡가
폴 로저스: 잉글랜드의 록 음악가
폴 칼데론: 푸에르토리코의 배우
폴 그레이엄: 프로그래머이자, 벤처 기업 투자가, 수필가
폴 앤더슨 (축구 선수): 잉글랜드의 축구 선수
폴 L. 프리먼 주니어: 1962년부터 1965년까지 미국 육군의 4성 장군으로 복무하면서 미국 유럽 육군을 이끌었던 총사령관
폴 케네디: 영국 태생의 역사학자
폴 모리아: 프랑스의 작곡가, 편곡가, 지휘자, 피아니스트, 쳄발로 연주자
폴 존슨: 잉글랜드의 작가이자 대중역사가
폴 포지션: 모터스포츠에 쓰이는 용어
폴 버터필드: 미국의 블루스 하모니카 연주자, 가수, 밴드 리더
폴 오컨폴드: 잉글랜드의 디스크자키이자 음악 프로듀서
폴 E. 제이컵스: 현재 퀄컴의 최고 경영자(CEO)
폴 슐즈: 미국의 배우
폴 F. 톰프킨스: 미국의 희극인이자 배우
폴 윌리엄스: 미국의 R&B 가수 겸 무용가
폴 조핸슨: 미국의 배우
폴 매너포트: 미국 로비스트이며 정치인
폴 와일리: 미국의 피겨 스케이팅 선수
폴 선형 리: 캐나다의 배우
폴 월포위츠: 전 세계은행의 총재, 미국의 전 인도네시아 대사, 국방부 부장관, 존스 홉킨스 대학교 폴 니츠 고등국제학대학의 전 학장
폴 캠벨: 캐나다의 배우
폴 스베레 발헤임 하겐: 노르웨이의 배우
폴 블레이: 캐나다의 모던 재즈 피아니스트
댄싱 폴 베어러스: 가나 남부의 아크라 지역 에 위치한 프람 프람 해안 마을 지역의 폴 베어러스 그룹
폴 아이딩: 미국의 성우
수브라타 폴: 인도의 축구 선수로 뭄바이 시티 FC에서 뛰고 있다.
폴 그로스: 캐나다의 배우
폴 왓슨: 캐나다의 환경 운동가
존 폴 존스 (군인): 미국 독립 전쟁의 대륙 해군의 군인
폴 앤더슨 (작가): 미국의 소설가, SF 작가
폴 제이컵스 (동명이인)
폴 부르제: 프랑스의 소설가이자 비평가
폴 젱킨스: 영국 출신의 만화가
에이드리언 폴: 잉글랜드의 배우
폴 매크레인: 미국의 배우
폴 맥길리언: 영국 스코틀랜드의 배우
폴 고사: 미국 공화당 소속의 정치인
폴 루디시: 미국의 애니메이터, 작가, 그리고 성우
폴 니컬스: 잉글랜드의 배우
폴 슈나이더 (배우): 미국의 배우
폴 윈첼: 미국의 배우
폴 존슨 (작가): 잉글랜드의 저널리스트이자 대중 역사가, 작가
폴 스위지: 미국의 경제학자이자, 마르크스주의이론가
폴 스미스 (패션 디자이너): 영국의 패션 디자이너
폴 러스트: 미국의 배우, 희극인 및 각본가
폴 몽텔: 프랑스의 수학자
폴 크레스톤: 미국의 서양 고전음악 작곡가
폴 밴뷰런: 미국의 기독교 신학자
폴 마이어 (통계학자)
폴 스투키: 피터, 폴 앤 메리의 "폴"(Paul)로 잘 알려진 싱어 송어라이터
폴 토머스 (베이스 기타 연주자): 미국의 음악가
폴 웨슬리: 미국의 에로배우
폴 히긴스: 스코틀랜드의 배우
폴 로런스 던바: 1890년대와 1900년대 초반에 인기있던 미국의 시인들 중의 하나였으며, 아프리카계 미국인으로선 처음으로 국내적으로 인기있던 시인이자 소설가
알렉산드라 폴: 미국의 배우
폴 앤더슨 (배우): 잉글랜드의 배우
폴 블랙손: 잉글랜드의 배우
폴 골드슈미트: 메이저 리그 세인트루이스 카디널스의 주전 1루수
폴 자쿨레: 프랑스 출신의 화가
폴 스카롱: 루이 13세 시대의 작가
폴 세뤼지에: 추상미술의 선구자이자 전위 예술 나비파 운동, 생테티슴, 클루아조니즘의 영감을 준 프랑스의 화가
폴 프레더릭 프랭클린 더글러스: 미국의 외교관 겸 정치가를 지낸 백·흑인 혼혈(물라토) 출신의 대학 교수
폴 고갱 박물관: 타히티섬에 위치한 일본식 미술관
폴 도슨: 미국의 배우
폴 보스타프: 미국의 드러머
폴 버칠: 영국의 전 프로레슬링선수
폴 슈에레브: 몰타의 정치인
폴 R. 하우스: 미국의 구약 학자, 저자, 그리고 신학교 교수
폴 스튜어트 (배우): 미국의 라디오, 영화, 텔레비전, 연극 배우이자 감독, 제작자
폴 램지: 20세기 미국의 기독교윤리 학자
폴 반 에이크: 쿡 제도의 축구 선수로 포지션은 수비수
폴 밀샙: 미국의 농구 선수이자 미 프로농구 애틀랜타 호크스의 선수
팔 폴 푹 쿤: 남수단의 축구 선수
폴 로건: 미국의 배우
폴 버나도: 캐나다의 연쇄살인자
폴 랜드: 미국의 그래픽 디자이너
폴 윌리엄스 (1915년): 미국의 남성 색소폰 연주가 겸 작곡가
폴 (베이커리): 프랑스에 본점을 둔 베이커리 전문점
폴 울리: 미국 필라델피아에 있는 웨스트민스터 신학교에서 1929년 1977년에 은퇴할때까지 교회사 교수
폴 바셋: 오스트레일리아의 바리스타, 기업인
폴 J. 와이츠: 미국의 시험 비행사, 해군 군인, 항공우주공학자, NASA 비행사
폴 스미스 (음악가): 영국의 록 보컬리스트
폴 웰즈: 영국 리버풀 출생의 프랑스의 개혁신학자
폴 이아코노: 미국의 배우
폴 르노: 프랑스의 만화가
폴 테일러 (철학자): 미국의 윤리학자
폴 카스텔라노: 뉴욕 시의 마피아 보스
폴 투르니에: 스위스의 의사이며 작가
폴 가셰: 프랑스의 의사
폴 키파스키: 미국의 언어학자
폴 스트랜드: 미국의 사진사이자 영화제작자
폴 킴 (1981년): 한국계 미국인 가수
폴 누탈: 영국의 정치인
폴 윌리엄스 (1939년): 미국의 남성 가수이자 작사가이고 무용가 겸 안무가이며 뮤지컬 배우
장 폴 폰데르부르크: 스웨덴의 축구 선수
폴 델보: 벨기에의 화가
폴 비츠: 뉴욕 대학교의 심리학부의 명예 교수

가공의 인물
폴 피닉스: 철권 시리즈의 캐릭터
폴 버니언: 미국의 전설 이야기에 등장하는 인물

같이 보기
더 폴