폴리(poly, Paulie, Poli 등)는 다음을 의미한다.

폴리(poly)는 그리스어로 '많음'을 뜻하는 πολύς가 어원인 낱말이다. '많다'라는 의미를 가지고 있다.
폴리(Paulie)는 인명의 하나이다.

미디어
영화
《폴리》: 미국에서 제작된 존 로버츠 감독의 1998년 가족 영화

애니메이션
로보카 폴리: 로이비쥬얼이 제작한 대한민국의 교육 텔레비전 애니메이션

지명
폴리(Poli)는 이탈리아 라치오 주 로마 현에 위치한 코무네이다.
폴리 스트리트는 영국 스태퍼드셔주 스토크온트렌트에 위치한 거리 이름이다.

인명
폴리 버건: 미국의 배우, 가수
세라 폴리: 캐나다의 배우, 각본가, 영화 감독, 정치 운동가
폴리 홀리데이: 미국의 배우
안드레아 폴리: 이탈리아 축구 선수
제임스 폴리: 아일랜드의 크리켓 선수
폴리 워커: 잉글랜드의 배우
데이브 폴리: 캐나다의 배우 및 희극인
스콧 폴리: 미국의 배우
클레어 폴리: 미국의 배우
제임스 폴리 (기자): 미국의 보도기자
제니퍼 크리스털 폴리: 미국의 배우
폴리 드레이퍼: 미국의 배우, 각본가, 연출가
폴리 페럿: 미국의 배우
존 패트릭 폴리: 미국의 로마 가톨릭교회 추기경
마리오 아우렐리오 폴리: 아르헨티나의 로마 가톨릭교회 추기경
폴리 제노바: 불가리아의 가수
톰 폴리: 미국의 변호사이자 정치인
폴리 파슨스: 잉글랜드의 텔레비전 사회자
폴리 매칭거: 미국의 면역학자
믹 폴리: 본명은 마이클 프랜시스 폴리(Michael Francis Foley, 1965년 6월 7일 ~ )
나타샤 폴리: 러시아의 모델

보드게임의 한 종류
자세한 내용은 모노폴리 문서를 참고하십시오.

동물
프리티 폴리: 영국산 암말

기업
폴리 폴리: 시계, 쥬얼리, 패션 액세서리를 생산 및 판매하는 그리스에 본사를 둔 국제적인 회사

화학
폴리염화 비닐(polyvinyl chlorid): 열가소성 플라스틱의 하나
폴리비닐 알코올(polyvinyl alcohol): 물에 녹는 중합체
폴리에스터(polyester): 폴리머의 일종
폴리에틸렌(polyethylene): 열가소성 플라스틱의 하나

수학
폴리곤(polygon): 다각형

기타
폴리그래프(polygraph): 거짓말 탐지기