후안(스페인어: Juan)은 남자 이름이다.

카스티야의 왕
카스티야의 후안 1세(1358-1390)
카스티야의 후안 2세(1405-1454)
아라곤의 왕
아라곤의 후안 1세(1350-1396)
아라곤의 후안 2세(1398-1479)는 나바라의 왕도 겸한다.
나바라의 왕
나바라의 후안 1세(1316)
나바라의 후안 3세(1469-1516)
군사지도자
돈 후안 데 아우스트리아(1547–1578)
스페인의 왕
후안 카를로스 1세(1938-)돈 후안은 여러 문학 작품의 소재가 된 가상의 인물이다.
후안 세바스티안 베론: 아르헨티나를 대표했던 중앙 미드필더
후안 도밍고 페론: 아르헨티나의 군인 출신 정치인
후안 마누엘 산토스: 콜롬비아의 우파 정치인
후안 마타: 맨체스터 유나이티드에서 뛰고 있는 스페인의 축구 선수
후안 로만 리켈메: 아르헨티나의 전 축구 선수
후안 라몬 히메네스: 에스파냐의 시인
후안 안토니오 피시: 전 축구 선수
후안 콰드라도: 콜롬비아의 축구 선수
후안 프란시스코 토레스
후안 파블로 소린: 아르헨티나의 전 축구 선수
후안 세데뇨: 도미니카 공화국의 야구 선수
후안 우리베: 도미니카 공화국 출신의 프로 야구 선수
후안 카밀로 수니가: 콜롬비아의 축구 선수
후안 구티에레스 모레노: 스페인의 은퇴한 축구 선수
후안 페르난도 킨테로: 콜롬비아의 축구 선수
후안 에스티벤 벨레스: 콜롬비아의 축구 선수
후안 마누엘 판히오: 아르헨티나 출신의 레이싱 카 선수
후안 포이트: 아르헨티나의 축구 선수
후안 파블로 카리소: 아르헨티나의 축구 선수
후안 프란시스코 가르시아: 스페인의 옛 축구 선수
호세 후안 바스케스
후안 말다세나: 아르헨티나의 물리학자
후안 마누엘 데 로사스: 1829년부터 1852년까지 아르헨티나 연방을 통치한 독재자
후안 베르나트: 스페인의 축구 선수
후안 라몬 로페스 카로: 스페인의 축구 감독
후안 아랑고: 베네수엘라의 축구 선수
후안 과이도
후안 안토니오 사마란치
후안 산타마리아 국제공항
후안 사발라: 1932년 하계 올림픽 마라톤 부문에서 우승한 아르헨티나의 육상 선수
후안 알베르토 스키아피노
후안 마누엘 바르가스: 우니베르시타리오에서 뛰고 있는 선수
후안 파틸로: KBL 인천 전자랜드 엘리펀츠의 포워드
후안 벨라스코 알바라도: 페루의 좌파 군인 출신 정치가
후안 마르틴 델 포트로: 아르헨티나의 프로 테니스 선수
후안 데 보르본 이 바텐베르그
후안 이투르베: 티후아나에서 공격수로 뛰는 파라과이의 축구 선수
후안 비센테 고메스: 베네수엘라의 정치가이며 대통령
후안 세바스티안 엘카노: 스페인의 탐험가
후안 폰세 데 레온
후안 벨라스케스 틀라코친: 아즈텍 제국의 황족이자 스페인 식민지의 초대 통치자
후안 파블로 몬토야: 포뮬라 원과 CART 경기에 우승하면서 국제적으로 잘 알려진 콜롬비아의 자동차 경주인
후안 네그린: 에스파냐 출신의 정치가이자 의사
후안 피에르: 외야수로 활약한 전 미국의 프로 야구 선수
후안 오를란도 에르난데스: 온두라스의 정치인
후안 안토니오 라바예하: 우루과이의 정치인이자 혁명가
호세 후안 바레아: 푸에르토리코의 농구 선수이자, NBA 댈러스 매버릭스의 선수
후안 보르자 데 간디아 공작: 제2대 간디아 공작
후안 안토니오 바요나: 스페인 바르셀로나 출신의 영화 감독
후안 파블로 앙헬: 콜롬비아의 축구 선수로서, 포지션은 중앙 공격수
후안 마리아 보르다베리: 우루과이의 정치인
후안 린도: 중앙 아메리카의 보수주의 정치가
후안 마누엘 올리베라: 우루과이의 축구 선수
후안 폰세 엔릴레: 필리핀의 정치인, 관료, 교육자
후안 그리스
후안 가브리엘: 예명 후안 가브리엘(Juan Gabriel)로 잘 알려진 멕시코의 가수
후안 데 가라이: 에스파냐의 남아메리카 정복자
후안 바우티스타 아궤로: 파라과이의 전 축구 선수
후안 루나: 필리핀의 근대 화가이자 조각가, 독립운동가
후안 페르난데스
후안 에스나이데르: 아르헨티나의 은퇴한 축구 선수
후안 아파라: 파라과이의 우익 정치인
후안 로드리게스 카브리요: 포르투갈의 탐험가
후안 호세 플로레스: 에콰도르의 정치인
후안 데 카르타헤나: 마젤란 탐험대의 일원
후안 알메이다 보스케: 쿠바의 정치인이자 1950년대 쿠바 혁명의 초기 사령관들 중 한 명
후안 마요르가: 스페인의 문학가
후안 루이스 게라: 도미니카 공화국의 가수
후안 발레라이아칼라 갈리아노: 에스파냐의 소설가
후안 마누엘 델가도 요리아: 스페인의 축구 선수
후안 데 푸카
후안 칼라타유드
후안 히메네스 마요르: 페루의 정치인
후안 타푸레스: 15세기 카탈루냐의 모험가
후안 포를린: 아르헨티나의 축구 선수
후안 바레라: 니카라과의 축구 선수
후안 가라이사발: 예술가
후안 마누엘: 스페인어권에서 사용하는 이름
후안 마누엘 마르케스: 멕시코의 권투 선수
후안 소마비아: 칠레의 변호사이자 교수, 외교관
후안 루이스: '이타의 수석사제'(Archipreste de Hita)라는 별명으로 유명한 문필가
후안 마누엘 판히오 2세: 아르헨티나 출신의 레이싱 카 선수
후안 디에고 보토: 스페인의 배우로 아르헨티나 부에노스아이레스 출신
후안 데 라 코사: 에스파냐의 항해가, 지도제작사
후안 벨레스: 푸에르토리코의 가수이자 음악가
후안 베론: 아르헨티나의 전 축구 선수이자 현 지도자
후안 히네스 데 세풀베다: 에스파냐의 르네상스 인문주의자
후안 마누엘 인사우랄데: 아르헨티나의 축구 선수
후안 파블로: 스페인어권에서 사용하는 이름
후안 아라네타: 필리핀의 기업가 겸 정치가
후안 파블로 야노: 콜롬비아의 배우이자 모델
후안 니카시오: 도미니카 공화국출신의 야구 선수
후안 소토: 도미니카 공화국 출신의 메이저 리그의 선수
후안 가르시아 포스티고: 스페인의 남자 모델
후안 루이스 데 알라르콘: 에스파냐의 극작가

같이 보기
후안 카를로스 (동음이의): 스페인어권에서 사용하는 이름