힐은 다음 뜻으로 쓰인다.

구두의 굽(heel)
하이힐(high heel)
힐 권: 어떤 천체가 위성을 지배적으로 끌어당길 수 있는 영역
힐 사면체: 공간 채우기 사면체족

인명
나폴리언 힐(Napoleon Hill, 1883 ~ 1970)은 미국의 작가이다.
롤런드 힐(Rowland Hill, 1795 ~ 1879)은 영국의 교육자로, 우표를 만든 사람으로 알려져 있다.
로린 힐(Lauryn Hill, 1975 ~ )은 미국의 가수, 배우이다.
베니 힐(Benny Hill, 1924 ~ 1992)은 영국의 코미디언, 배우, 가수이다.
에런 힐(Aaron Walter Hill, 1982 ~ )은 미국의 야구 선수이다.
앰브로스 파웰 힐(Ambrose Powell Hill, 1825 ~ 1865)은 미국의 군인이다.
월터 힐(Walter Hill, 1940 ~ )은 미국의 영화 제작자이다.
크리스토퍼 힐(Christopher Hill, 1952 ~ )은 미국의 외교관이다.
아치볼드 비비언 힐: 생물 물리학을 창시한 사람 중 한 명
조지 로이 힐: 미국의 영화 감독
테일러 힐: 간단히 테일러 힐(영어: Taylor Hill)로 잘 알려진 미국의 모델
제1대 힐 자작 롤랜드 힐: 나폴레옹 전쟁 당시 영국 육군에서 복무했던 장교
조나 힐: 미국의 배우, 영화 감독, 영화 각본가
에밀리오 포르테스 힐: 1928년부터 1930년까지 역임한 멕시코의 대통령
토머스 힐 그린: 영국의 관념론 철학자
앨버트 힐: 영국의 육상 선수
아리아드나 힐: 스페인의 배우
데이먼 힐: 영국의 모터스포츠 선수
이언 힐: 헤비 메탈 밴드 주다스 프리스트의 베이시스트로 가장 잘 알려진 영국의 음악가
그랜트 힐: 은퇴한 미국의 농구 선수
힐 하퍼: 미국의 배우
클린트 힐 (축구 선수): 잉글랜드의 전 축구 선수
버나드 힐: 잉글랜드의 배우
힐 알바레스 카리요 데 알보르노스: 스페인의 추기경이자 교회군 지도자
잭 힐: 미국의 배우
엔리케 힐: 필리핀의 배우이자 가수
스티븐 힐: 미국의 배우
도로시 포인턴 힐: 미국의 여성 다이빙 선수
페이스 힐: 미국의 컨트리 가수
예두아르트 힐: 러시아의 바리톤 성악가
카를레스 힐: 스페인의 축구 선수
콘리스 힐: 북아일랜드의 배우
랠프 힐: 미국의 장거리달리기 선수
둘레 힐: 미국의 배우
클린트 힐: 영국의 축구 선수
조지 힐: 싱글 스케이팅과 페어 스케이팅에 참가한 미국의 피겨 스케이팅 선수
퍼트리샤 힐 콜린스: 미국의 사회학자이자 메릴랜드 대학교의 교수
조 힐: 미국의 노동운동가
제임스 제롬 힐: 19세기 후반부터 20세기 초에 걸쳐 미국에서 철도 경영을 맡은 캐나다계 미국인
조 힐 (작가): 조 힐(Joe Hill)이라는 필명으로 잘 알려진 미국의 작가
워드 힐 라몬: 미국 대통령 에이브러햄 링컨의 친구이자, 스스로 임명한 보디가드
머리 힐: 뉴욕 시에서 활동하는 드래그 킹
니키 힐: 필리핀의 가수, 배우, 사회자, 모델
알프레도 힐: 멕시코의 가수, 작사가 겸 기타 연주자
가스톤 힐 로메로: 아르헨티나의 축구 선수
에런 힐 (야구 선수): 미국 프로 야구 애리조나 다이아몬드백스의 선수
테렌스 힐: 이탈리아의 영화 감독, 희극 배우, 텔레비전 감독, 텔레비전 프로듀서, 영화배우, 영화 프로듀서, 텔레비전 배우
에리카 힐: 미국의 저널리스트, 뉴스 캐스터
레일리 힐: 오스트레일리아의 배우
루시아 힐: 스페인의 가수, 배우, 사회자
매디 힐: 잉글랜드의 배우
베키 힐: 잉글랜드의 싱어송라이터
윌리엄 힐: 영국의 도박 회사
더스티 힐: 미국의 베이시스트
크리스토퍼 힐 (1912년): 영국의 마르크스주의 역사가이자 역사 교과서의 저자
에런 힐 (배우): 미국의 배우
레스 힐: 오스트레일리아의 배우
버질 힐: 미국의 권투 선수
데이너 힐: 미국의 배우, 가수, 댄서, 성우, 희극 배우, 연극 배우
아더 힐: 캐나다의 연극 배우, 영화배우, 텔레비전 배우
진 힐: 미국의 모델, 배우, 영화배우, 교사
테레사 힐: 미국의 배우, 텔레비전 배우, 영화배우
드웨인 힐: 캐나다의 성우, 배우, 텔레비전 배우
엘 힐: 미국의 배우
에이미 힐: 미국의 배우, 텔레비전 배우, 성우, 영화배우
존 마이클 힐: 미국의 배우, 연극 배우, 텔레비전 배우, 영화배우
제니퍼 힐: 캐나다의 배우
마리아나 힐: 미국의 텔레비전 배우, 영화배우
셰리 힐: 필리핀의 배우
조지 힐 (목회자): 세인트앤드루 교구의 목회자

가공의 인물
마리아 힐: 마블 코믹스의 등장인물

같이 보기
힐 시약